ID,Fläche,Zimmer,Kanton,PLZ,Preis,Durchschnittspreis Wohnung,Preisdifferenz,Preisdifferenz/Zimmer,Durchschnittspreis/m2
1,28,1,Luzern,6003,963,526,-437,-437,"18,8"
2,35,1,Luzern,6003,1100,658,-442,-442,"18,8"
3,35,1,Luzern,6003,1063,658,-405,-405,"18,8"
5,42,2,Thurgau,9320,920,605,-315,-158,"14,4"
6,65,4,Schaffhausen,8200,1076,832,-244,-61,"12,8"
10,50,"2,5",Genf,1202,1690,932,-758,-303,"18,65"
11,130,"3,5",Tessin,6925,2500,1755,-745,-213,"13,5"
13,55,"2,5",Zürich,8902,1550,1084,-466,-186,"19,7"
16,50,2,Zürich,8049,1750,1035,-715,-358,"20,7"
17,100,"4,5",Zürich,8057,2100,1755,-345,-77,"17,55"
18,18,1,Zürich,8156,870,392,-478,-478,"21,8"
36,116,"3,5",Zürich,8712,1990,2100,110,31,"18,1"
39,124,"4,5",Aargau,5506,2130,1767,-363,-81,"14,25"
40,110,"3,5",Zürich,8134,2850,1991,-859,-245,"18,1"
41,71,3,Zürich,8050,2020,1328,-692,-231,"18,7"
42,105,1,Zürich,8057,2000,2289,289,289,"21,8"
58,90,"3,5",Aargau,5417,1730,1323,-407,-116,"14,7"
59,130,"4,5",Aargau,5620,1990,1853,-137,-30,"14,25"
60,116,"4,5",Aargau,5612,2300,1653,-647,-144,"14,25"
61,53,"2,5",Zürich,8600,1760,1044,-716,-286,"19,7"
65,123,"4,5",Thurgau,9225,1970,1519,-451,-100,"12,35"
66,65,"1,5",Zürich,8914,1180,1381,201,134,"21,25"
70,45,2,Zürich,8044,2151,932,-1219,-610,"20,7"
72,110,4,St. Gallen,9000,1600,1463,-137,-34,"13,3"
75,65,"3,5",Aargau,5032,1030,956,-74,-21,"14,7"
76,75,3,Zürich,8153,1100,1403,303,101,"18,7"
77,105,"4,5",Aargau,5430,1980,1496,-484,-108,"14,25"
78,40,1,Luzern,6004,1400,752,-648,-648,"18,8"
92,100,"3,5",Aargau,5442,1870,1470,-400,-114,"14,7"
93,45,"1,5",Graubünden,7000,850,790,-60,-40,"17,55"
95,80,"3,5",Thurgau,9500,1400,1068,-332,-95,"13,35"
95,80,"3,5",St. Gallen,9500,1400,1108,-292,-83,"13,85"
96,73,"3,5",Luzern,6003,1800,1080,-720,-206,"14,8"
97,84,"3,5",Zürich,8047,2630,1520,-1110,-317,"18,1"
98,30,"1,5",Zürich,8003,1899,638,-1261,-841,"21,25"
99,99,"2,5",Solothurn,4600,1400,1361,-39,-16,"13,75"
99,99,"2,5",Aargau,4600,1400,1539,139,56,"15,55"
100,100,3,Solothurn,4600,1430,1360,-70,-23,"13,6"
100,100,3,Aargau,4600,1430,1510,80,27,"15,1"
102,187,"4,5",Solothurn,4622,2241,2412,171,38,"12,9"
106,28,"1,5",Nidwalden,6377,660,437,-223,-149,"15,6"
106,28,"1,5",Uri,6377,660,375,-285,-190,"13,4"
107,85,"4,5",Aargau,5103,1490,1211,-279,-62,"14,25"
108,85,"4,5",Aargau,5103,1490,1211,-279,-62,"14,25"
109,45,2,Luzern,6003,1350,756,-594,-297,"16,8"
110,70,"2,5",St. Gallen,9434,1590,1043,-547,-219,"14,9"
111,93,"3,5",St. Gallen,9434,1730,1288,-442,-126,"13,85"
113,95,"3,5",Basel-Landschaft,4467,1160,1563,403,115,"16,45"
114,109,5,St. Gallen,9000,1700,1395,-305,-61,"12,8"
115,100,"2,5",Basel-Landschaft,4153,1700,1690,-10,-4,"16,9"
117,130,"4,5",St. Gallen,9308,2170,1697,-473,-105,"13,05"
118,120,"4,5",Aargau,8966,2190,1710,-480,-107,"14,25"
120,157,"5,5",Aargau,5734,1980,2222,242,44,"14,15"
121,140,"4,5",Aargau,4334,1730,1995,265,59,"14,25"
123,106,"4,5",Schaffhausen,8219,1450,1383,-67,-15,"13,05"
124,80,"4,5",Bern,2740,1020,1108,88,20,"13,85"
126,200,"5,5",Zürich,8340,3250,3570,320,58,"17,85"
128,30,"1,5",St. Gallen,9220,890,470,-420,-280,"15,65"
128,30,"1,5",Thurgau,9220,890,423,-467,-311,"14,1"
129,125,"3,5",Aargau,5076,1770,1838,68,19,"14,7"
130,115,"4,5",Basel-Stadt,4058,2020,1955,-65,-14,17
134,75,"3,5",Zürich,8820,2190,1358,-832,-238,"18,1"
137,115,"4,5",Basel-Landschaft,4123,2500,1898,-602,-134,"16,5"
138,140,"4,5",Wallis,1965,1850,1778,-72,-16,"12,7"
140,120,"3,5",Zürich,8302,2350,2172,-178,-51,"18,1"
141,111,"4,5",Solothurn,4566,2000,1432,-568,-126,"12,9"
142,140,"4,5",Aargau,5723,2100,1995,-105,-23,"14,25"
143,150,"4,5",Zürich,8165,2350,2633,283,63,"17,55"
144,125,"4,5",Thurgau,8500,2900,1544,-1356,-301,"12,35"
144,125,"4,5",Zürich,8500,2900,2194,-706,-157,"17,55"
148,52,"2,5",Bern,2740,790,772,-18,-7,"14,85"
149,110,"4,5",Luzern,6294,1800,1556,-244,-54,"14,15"
151,86,3,St. Gallen,9220,1220,1238,18,6,"14,4"
151,86,3,Thurgau,9220,1220,1195,-25,-8,"13,9"
152,145,"5,5",Luzern,6215,2500,2052,-448,-81,"14,15"
153,80,"4,5",Bern,2740,1020,1108,88,20,"13,85"
154,105,"3,5",Bern,3412,1600,1502,-98,-28,"14,3"
155,110,"4,5",St. Gallen,9552,1690,1436,-254,-56,"13,05"
156,100,"4,5",St. Gallen,9032,1750,1305,-445,-99,"13,05"
157,96,"4,5",Nidwalden,6374,1550,1440,-110,-24,15
159,100,"3,5",Luzern,6126,1250,1480,230,66,"14,8"
160,100,"3,5",Aargau,8916,1960,1470,-490,-140,"14,7"
161,180,"5,5",Solothurn,4718,1650,2349,699,127,"13,05"
162,82,"3,5",Basel-Stadt,4054,1870,1374,-496,-142,"16,75"
163,90,"2,5",Zug,6319,2700,1854,-846,-338,"20,6"
164,120,"3,5",Zürich,8322,1690,2172,482,138,"18,1"
166,62,3,Solothurn,4500,1280,843,-437,-146,"13,6"
167,80,"3,5",Zürich,8624,1780,1448,-332,-95,"18,1"
168,86,"3,5",Aargau,5622,1700,1264,-436,-125,"14,7"
169,125,"3,5",Bern,3155,1730,1788,58,17,"14,3"
172,104,"4,5",Luzern,6144,1500,1472,-28,-6,"14,15"
174,120,"4,5",Bern,3538,1290,1662,372,83,"13,85"
175,121,"4,5",Obwalden,6010,1980,1597,-383,-85,"13,2"
175,121,"4,5",Nidwalden,6010,1980,1815,-165,-37,15
175,121,"4,5",Luzern,6010,1980,1712,-268,-60,"14,15"
176,75,3,Bern,3095,3450,1088,-2362,-787,"14,5"
177,120,"5,5",Schwyz,6442,1930,1950,20,4,"16,25"
181,75,"2,5",Tessin,6900,1380,1001,-379,-152,"13,35"
182,66,"3,5",Tessin,6953,1390,891,-499,-143,"13,5"
183,44,1,Tessin,6900,850,515,-335,-335,"11,7"
184,140,"4,5",Tessin,6987,1900,1939,39,9,"13,85"
185,150,"4,5",Tessin,6983,1700,2078,378,84,"13,85"
186,75,"2,5",Tessin,6817,1500,1001,-499,-200,"13,35"
187,260,"4,5",Tessin,6900,3900,3601,-299,-66,"13,85"
188,150,"4,5",Tessin,6963,3100,2078,-1022,-227,"13,85"
190,62,"2,5",Tessin,6850,1180,828,-352,-141,"13,35"
191,100,"3,5",Tessin,6932,2050,1350,-700,-200,"13,5"
193,44,"1,5",Tessin,6912,950,548,-402,-268,"12,45"
194,57,"2,5",Tessin,6816,980,761,-219,-88,"13,35"
195,88,"3,5",Zürich,8196,1890,1593,-297,-85,"18,1"
196,105,4,Waadt,1278,2015,1670,-345,-86,"15,9"
198,50,"2,5",Genf,1202,1690,932,-758,-303,"18,65"
199,100,3,Solothurn,4600,1430,1360,-70,-23,"13,6"
199,100,3,Aargau,4600,1430,1510,80,27,"15,1"
200,99,"2,5",Solothurn,4600,1400,1361,-39,-16,"13,75"
200,99,"2,5",Aargau,4600,1400,1539,139,56,"15,55"
201,79,3,Zürich,8802,2430,1477,-953,-318,"18,7"
202,85,"3,5",Bern,3604,1730,1216,-514,-147,"14,3"
203,66,3,Solothurn,4600,1300,898,-402,-134,"13,6"
203,66,3,Aargau,4600,1300,997,-303,-101,"15,1"
204,56,2,Freiburg,1700,1321,879,-442,-221,"15,7"
206,65,"3,5",Aargau,4802,1200,956,-244,-70,"14,7"
208,128,"4,5",Solothurn,4528,2250,1651,-599,-133,"12,9"
209,80,"4,5",Graubünden,7000,1390,1080,-310,-69,"13,5"
210,60,"2,5",Graubünden,7408,1295,951,-344,-138,"15,85"
230,102,"4,5",St. Gallen,9200,1924,1331,-593,-132,"13,05"
231,65,"2,5",St. Gallen,9200,1390,969,-421,-168,"14,9"
232,90,"3,5",St. Gallen,9200,1716,1247,-469,-134,"13,85"
233,48,"2,5",Waadt,1260,1490,850,-640,-256,"17,7"
234,69,3,Neuchâtel,2300,1130,807,-323,-108,"11,7"
235,54,2,Waadt,1018,1670,988,-682,-341,"18,3"
236,80,"3,5",Schaffhausen,8200,1690,1052,-638,-182,"13,15"
238,140,"4,5",Neuchâtel,2000,2915,1743,-1172,-260,"12,45"
239,140,"4,5",Neuchâtel,2000,2800,1743,-1057,-235,"12,45"
240,140,"5,5",Neuchâtel,2000,2820,1827,-993,-181,"13,05"
241,140,"4,5",Neuchâtel,2000,2605,1743,-862,-192,"12,45"
244,120,"3,5",Neuchâtel,2000,2380,1434,-946,-270,"11,95"
245,90,"3,5",Neuchâtel,2000,1798,1076,-722,-206,"11,95"
247,87,"3,5",Neuchâtel,2068,1720,1040,-680,-194,"11,95"
248,87,"3,5",Neuchâtel,2068,1720,1040,-680,-194,"11,95"
251,60,3,Neuchâtel,2400,920,702,-218,-73,"11,7"
252,43,1,Neuchâtel,2000,1150,512,-638,-638,"11,9"
253,55,"2,5",Neuchâtel,2000,1440,668,-772,-309,"12,15"
254,42,1,Neuchâtel,2000,1005,500,-505,-505,"11,9"
255,80,3,Neuchâtel,2300,1050,936,-114,-38,"11,7"
256,68,"2,5",Neuchâtel,2000,1160,826,-334,-134,"12,15"
257,35,1,Neuchâtel,2000,990,417,-573,-573,"11,9"
258,47,1,Neuchâtel,2000,940,559,-381,-381,"11,9"
261,110,5,Neuchâtel,2400,955,1397,442,88,"12,7"
264,100,"4,5",Neuchâtel,2000,2290,1245,-1045,-232,"12,45"
265,133,"4,5",Waadt,1040,2320,2168,-152,-34,"16,3"
267,90,"3,5",Neuchâtel,2053,1500,1076,-424,-121,"11,95"
272,88,"3,5",Waadt,1040,1900,1452,-448,-128,"16,5"
273,110,"4,5",Waadt,1522,1925,1793,-132,-29,"16,3"
274,110,"4,5",Waadt,1522,2000,1793,-207,-46,"16,3"
275,98,"2,5",Waadt,1063,1590,1735,145,58,"17,7"
276,110,"4,5",Waadt,1522,1968,1793,-175,-39,"16,3"
278,110,"4,5",Waadt,1522,2000,1793,-207,-46,"16,3"
279,59,"3,5",Waadt,1337,990,974,-16,-5,"16,5"
280,98,"3,5",Waadt,1063,1690,1617,-73,-21,"16,5"
291,140,"5,5",Nidwalden,6052,2400,2058,-342,-62,"14,7"
291,140,"5,5",Luzern,6052,2400,1981,-419,-76,"14,15"
292,80,"3,5",Zürich,8032,2365,1448,-917,-262,"18,1"
294,123,"4,5",Thurgau,9225,1970,1519,-451,-100,"12,35"
300,100,"4,5",Tessin,6710,1437,1385,-52,-12,"13,85"
303,85,"3,5",St. Gallen,9400,1270,1177,-93,-27,"13,85"
306,51,2,Basel-Stadt,4058,1490,928,-562,-281,"18,2"
307,80,"4,5",Bern,3600,1690,1108,-582,-129,"13,85"
308,75,"3,5",Graubünden,7000,1542,1129,-413,-118,"15,05"
309,23,1,Genf,1201,1240,453,-787,-787,"19,7"
310,87,"3,5",Basel-Landschaft,4153,1950,1431,-519,-148,"16,45"
312,45,"1,5",Basel-Stadt,4058,1220,803,-417,-278,"17,85"
313,44,2,Basel-Stadt,4058,1300,801,-499,-250,"18,2"
314,45,2,Basel-Stadt,4058,1220,819,-401,-201,"18,2"
315,109,"4,5",Basel-Landschaft,4203,1940,1799,-141,-31,"16,5"
316,62,"3,5",Basel-Landschaft,4127,1610,1020,-590,-169,"16,45"
318,55,2,Basel-Stadt,4057,1290,1001,-289,-145,"18,2"
319,54,2,Solothurn,4143,1140,751,-389,-195,"13,9"
322,135,"5,5",Zürich,8543,2800,2410,-390,-71,"17,85"
323,118,4,Thurgau,8580,1690,1510,-180,-45,"12,8"
323,118,4,St. Gallen,8580,1690,1569,-121,-30,"13,3"
325,112,"4,5",Appenzell Ausserrhoden,9053,1950,1372,-578,-128,"12,25"
325,112,"4,5",Appenzell Innerrhoden,9053,1950,1434,-516,-115,"12,8"
326,98,"4,5",St. Gallen,9437,1590,1279,-311,-69,"13,05"
326,98,"4,5",Appenzell Ausserrhoden,9437,1590,1201,-389,-86,"12,25"
327,55,"2,5",Thurgau,8580,1250,778,-472,-189,"14,15"
327,55,"2,5",St. Gallen,8580,1250,820,-430,-172,"14,9"
333,96,"4,5",Aargau,4310,1650,1368,-282,-63,"14,25"
334,48,2,Aargau,4310,1006,768,-238,-119,16
335,90,"3,5",Bern,2542,1515,1287,-228,-65,"14,3"
336,96,"4,5",Aargau,4310,1729,1368,-361,-80,"14,25"
337,73,"2,5",Aargau,4310,1456,1135,-321,-128,"15,55"
338,73,"2,5",Aargau,4310,1450,1135,-315,-126,"15,55"
339,85,"3,5",Aargau,4310,1622,1250,-372,-106,"14,7"
340,74,"2,5",Basel-Landschaft,4052,1840,1251,-589,-236,"16,9"
340,74,"2,5",Basel-Stadt,4052,1840,1295,-545,-218,"17,5"
341,112,"4,5",Thurgau,8547,2200,1383,-817,-182,"12,35"
346,85,"4,5",Aargau,5103,1490,1211,-279,-62,"14,25"
348,135,"4,5",Luzern,6353,3320,1910,-1410,-313,"14,15"
350,120,"4,5",Aargau,5037,1960,1710,-250,-56,"14,25"
351,150,6,Waadt,1295,5100,2595,-2505,-418,"17,3"
353,124,"4,5",Aargau,5506,2130,1767,-363,-81,"14,25"
354,125,"4,5",Basel-Landschaft,4153,3150,2063,-1087,-242,"16,5"
355,100,"4,5",Tessin,6710,1437,1385,-52,-12,"13,85"
359,86,"3,5",Neuchâtel,2024,1690,1028,-662,-189,"11,95"
361,24,1,Bern,3084,1440,384,-1056,-1056,16
364,109,"4,5",Thurgau,9315,1890,1346,-544,-121,"12,35"
364,109,"4,5",St. Gallen,9315,1890,1422,-468,-104,"13,05"
365,118,"4,5",Graubünden,7408,2040,1593,-447,-99,"13,5"
366,119,"4,5",Graubünden,7408,1940,1607,-333,-74,"13,5"
368,61,"2,5",Thurgau,9315,1360,863,-497,-199,"14,15"
368,61,"2,5",St. Gallen,9315,1360,909,-451,-180,"14,9"
369,88,"3,5",Graubünden,7408,1595,1324,-271,-77,"15,05"
370,60,"2,5",Graubünden,7408,1295,951,-344,-138,"15,85"
372,125,"4,5",St. Gallen,8645,2850,1631,-1219,-271,"13,05"
373,90,"3,5",Schaffhausen,8226,950,1184,234,67,"13,15"
374,55,2,Schaffhausen,8226,750,836,86,43,"15,2"
377,74,"3,5",St. Gallen,9016,1190,1025,-165,-47,"13,85"
384,90,"3,5",Zürich,8810,3350,1629,-1721,-492,"18,1"
386,121,4,Graubünden,7205,1950,1791,-159,-40,"14,8"
387,65,"3,5",Genf,1200,2200,1190,-1010,-289,"18,3"
388,35,"1,5",Luzern,6353,1100,623,-477,-318,"17,8"
389,92,"2,5",Zürich,8008,3495,1812,-1683,-673,"19,7"
390,68,"1,5",Zürich,8008,2895,1445,-1450,-967,"21,25"
391,55,"2,5",Zürich,8637,1130,1084,-46,-18,"19,7"
391,55,"2,5",St. Gallen,8637,1130,820,-310,-124,"14,9"
392,55,"2,5",St. Gallen,8636,1130,820,-310,-124,"14,9"
392,55,"2,5",Zürich,8636,1130,1084,-46,-18,"19,7"
393,18,1,Zürich,8330,1490,392,-1098,-1098,"21,8"
397,100,"3,5",Basel-Landschaft,4457,2055,1645,-410,-117,"16,45"
401,60,"2,5",Aargau,5412,995,933,-62,-25,"15,55"
402,75,"3,5",Zürich,8800,2290,1358,-932,-266,"18,1"
404,61,"2,5",Aargau,8965,1067,949,-118,-47,"15,55"
406,70,"2,5",Solothurn,5014,1350,963,-387,-155,"13,75"
407,110,"4,5",Luzern,6022,1400,1556,156,35,"14,15"
427,33,"1,5",Thurgau,8532,900,465,-435,-290,"14,1"
428,150,"3,5",Zürich,8700,4340,2715,-1625,-464,"18,1"
429,58,"2,5",Zürich,8006,1960,1143,-817,-327,"19,7"
431,60,"2,5",Zürich,8050,1960,1182,-778,-311,"19,7"
433,95,"4,5",Aargau,5737,1420,1354,-66,-15,"14,25"
435,72,"2,5",Zürich,8006,2290,1418,-872,-349,"19,7"
436,63,"1,5",Aargau,5108,1080,1017,-63,-42,"16,15"
447,56,2,Zürich,8303,1548,1159,-389,-195,"20,7"
449,100,"3,5",Tessin,6977,2800,1350,-1450,-414,"13,5"
450,100,"3,5",Zürich,8143,2100,1810,-290,-83,"18,1"
453,24,"1,5",Zürich,8802,980,510,-470,-313,"21,25"
454,98,"4,5",Basel-Landschaft,4102,2200,1617,-583,-130,"16,5"
456,28,1,Waadt,1860,560,596,36,36,"21,3"
462,15,"4,5",Zürich,8049,900,263,-637,-142,"17,55"
465,60,"3,5",Zürich,8003,1500,1086,-414,-118,"18,1"
469,105,"4,5",Thurgau,9555,1510,1297,-213,-47,"12,35"
488,55,2,Zürich,8413,1398,1139,-259,-130,"20,7"
490,95,"3,5",Freiburg,1793,1250,1344,94,27,"14,15"
491,23,1,Genf,1201,1240,453,-787,-787,"19,7"
493,100,"3,5",Zürich,8483,1950,1810,-140,-40,"18,1"
496,67,3,Zürich,8902,1655,1253,-402,-134,"18,7"
497,60,"2,5",Zürich,8057,1246,1182,-64,-26,"19,7"
498,130,"4,5",Schwyz,8834,2790,2035,-755,-168,"15,65"
502,35,"1,5",Zürich,8057,1150,744,-406,-271,"21,25"
503,40,"1,5",Freiburg,1680,950,678,-272,-181,"16,95"
504,36,1,Waadt,1530,670,767,97,97,"21,3"
505,113,"3,5",Wallis,1872,1400,1497,97,28,"13,25"
506,96,"4,5",Freiburg,1694,1770,1296,-474,-105,"13,5"
507,96,"4,5",Freiburg,1694,1970,1296,-674,-150,"13,5"
509,166,"5,5",Waadt,1009,6000,2822,-3178,-578,17
510,105,"3,5",Freiburg,1680,1570,1486,-84,-24,"14,15"
515,80,"3,5",St. Gallen,9400,1130,1108,-22,-6,"13,85"
516,103,"4,5",St. Gallen,9300,1640,1344,-296,-66,"13,05"
517,105,"4,5",Thurgau,8274,1580,1297,-283,-63,"12,35"
518,98,"4,5",Thurgau,9320,1690,1210,-480,-107,"12,35"
521,73,"3,5",St. Gallen,9230,1190,1011,-179,-51,"13,85"
522,35,"1,5",Zug,6340,1590,767,-823,-549,"21,9"
523,92,"4,5",Aargau,5727,1470,1311,-159,-35,"14,25"
524,108,"4,5",Luzern,6024,1985,1528,-457,-102,"14,15"
525,112,"4,5",Basel-Stadt,4058,2300,1904,-396,-88,17
527,134,6,Nidwalden,6374,2700,1943,-757,-126,"14,5"
528,100,"3,5",Solothurn,4232,1500,1325,-175,-50,"13,25"
529,35,3,Appenzell Ausserrhoden,9103,730,448,-282,-94,"12,8"
529,35,3,St. Gallen,9103,730,504,-226,-75,"14,4"
530,45,"1,5",St. Gallen,7317,700,704,4,3,"15,65"
531,119,"4,5",Basel-Landschaft,4460,1900,1964,64,14,"16,5"
532,56,2,St. Gallen,9000,1090,862,-228,-114,"15,4"
535,80,4,Basel-Landschaft,4424,1690,1296,-394,-99,"16,2"
536,75,"3,5",Nidwalden,6052,1750,1193,-557,-159,"15,9"
536,75,"3,5",Luzern,6052,1750,1110,-640,-183,"14,8"
537,172,"5,5",Basel-Landschaft,4123,3500,3027,-473,-86,"17,6"
538,83,"4,5",Nidwalden,6370,2100,1245,-855,-190,15
543,60,"2,5",Zürich,8353,1500,1182,-318,-127,"19,7"
544,78,"3,5",Luzern,6003,1760,1154,-606,-173,"14,8"
548,36,1,Waadt,1530,670,767,97,97,"21,3"
549,126,"5,5",Wallis,1950,1850,1688,-162,-29,"13,4"
550,120,"4,5",Thurgau,8586,1745,1482,-263,-58,"12,35"
551,120,"5,5",Thurgau,8274,1750,1422,-328,-60,"11,85"
553,80,4,Genf,1208,2120,1448,-672,-168,"18,1"
554,64,"2,5",St. Gallen,9400,1250,954,-296,-118,"14,9"
555,102,"4,5",Graubünden,7014,2080,1377,-703,-156,"13,5"
556,102,"4,5",Graubünden,7014,2370,1377,-993,-221,"13,5"
558,55,"2,5",Zürich,8052,1700,1084,-616,-246,"19,7"
559,146,"3,5",St. Gallen,9400,1790,2022,232,66,"13,85"
560,65,"2,5",St. Gallen,9643,700,969,269,108,"14,9"
561,25,1,Bern,3004,690,400,-290,-290,16
562,65,"2,5",Luzern,6032,1410,1047,-363,-145,"16,1"
563,83,"3,5",Luzern,6032,1710,1228,-482,-138,"14,8"
564,104,"3,5",St. Gallen,9323,1920,1440,-480,-137,"13,85"
567,32,2,Wallis,3920,990,477,-513,-257,"14,9"
568,61,"2,5",Basel-Stadt,4058,979,1068,89,36,"17,5"
569,109,"4,5",Luzern,6005,2450,1542,-908,-202,"14,15"
571,136,"4,5",Glarus,8752,2290,1646,-644,-143,"12,1"
574,80,3,Basel-Landschaft,4123,1670,1336,-334,-111,"16,7"
575,56,3,Basel-Landschaft,4410,1180,935,-245,-82,"16,7"
576,111,"4,5",Basel-Landschaft,4410,2026,1832,-194,-43,"16,5"
577,94,"4,5",Basel-Landschaft,4450,1790,1551,-239,-53,"16,5"
578,65,3,Basel-Landschaft,4414,1172,1086,-86,-29,"16,7"
579,22,1,Basel-Landschaft,4415,415,374,-41,-41,17
580,75,"3,5",Basel-Landschaft,4153,1750,1234,-516,-147,"16,45"
581,91,"4,5",Basel-Landschaft,4450,1645,1502,-143,-32,"16,5"
583,58,"2,5",Basel-Landschaft,4414,1370,980,-390,-156,"16,9"
584,66,3,Basel-Landschaft,4414,1500,1102,-398,-133,"16,7"
587,62,"2,5",Zürich,8050,1970,1221,-749,-300,"19,7"
590,16,1,St. Gallen,9475,490,254,-236,-236,"15,9"
591,90,"4,5",Schwyz,6440,1600,1409,-191,-42,"15,65"
595,125,"4,5",St. Gallen,9435,2040,1631,-409,-91,"13,05"
597,39,"1,5",St. Gallen,9630,770,610,-160,-107,"15,65"
598,65,4,St. Gallen,9000,1390,865,-525,-131,"13,3"
599,63,3,Thurgau,9320,1090,876,-214,-71,"13,9"
600,85,4,St. Gallen,9000,1680,1131,-549,-137,"13,3"
601,90,4,St. Gallen,9000,1690,1197,-493,-123,"13,3"
602,47,2,St. Gallen,9000,1450,724,-726,-363,"15,4"
603,27,1,St. Gallen,9475,880,429,-451,-451,"15,9"
604,85,4,St. Gallen,9008,1290,1131,-159,-40,"13,3"
605,105,"3,5",Thurgau,9322,1480,1402,-78,-22,"13,35"
606,100,"3,5",St. Gallen,9400,1690,1385,-305,-87,"13,85"
608,100,"3,5",St. Gallen,9400,1690,1385,-305,-87,"13,85"
609,98,"4,5",Basel-Landschaft,4102,2200,1617,-583,-130,"16,5"
611,40,2,St. Gallen,9000,1100,616,-484,-242,"15,4"
615,78,"3,5",Waadt,1400,1752,1287,-465,-133,"16,5"
616,93,3,Freiburg,1633,1630,1376,-254,-85,"14,8"
619,60,"2,5",Thurgau,8370,1240,849,-391,-156,"14,15"
621,126,6,Luzern,6182,1850,1789,-61,-10,"14,2"
623,80,"2,5",Aargau,5607,1445,1244,-201,-80,"15,55"
626,100,"3,5",Zürich,8803,3875,1810,-2065,-590,"18,1"
628,120,"3,5",Neuchâtel,2300,1500,1434,-66,-19,"11,95"
629,114,"4,5",St. Gallen,9107,1430,1488,58,13,"13,05"
629,114,"4,5",Appenzell Innerrhoden,9107,1430,1459,29,6,"12,8"
629,114,"4,5",Appenzell Ausserrhoden,9107,1430,1397,-33,-7,"12,25"
630,50,"2,5",Basel-Landschaft,4242,1140,845,-295,-118,"16,9"
631,18,1,Zürich,8156,870,392,-478,-478,"21,8"
632,50,2,Basel-Landschaft,4242,1150,855,-295,-148,"17,1"
633,126,"5,5",Luzern,6182,1750,1783,33,6,"14,15"
634,75,"2,5",Schwyz,8855,1600,1279,-321,-128,"17,05"
635,75,3,Basel-Landschaft,4242,1590,1253,-337,-112,"16,7"
637,88,4,Zürich,8112,1750,1540,-210,-53,"17,5"
643,77,4,Zürich,8610,1590,1348,-242,-61,"17,5"
661,116,"4,5",Aargau,5600,2440,1653,-787,-175,"14,25"
662,121,"4,5",Zürich,8157,2060,2124,64,14,"17,55"
663,98,"4,5",Zürich,8162,2050,1720,-330,-73,"17,55"
664,60,"2,5",Zürich,8302,1680,1182,-498,-199,"19,7"
665,92,5,Glarus,8752,1550,1058,-492,-98,"11,5"
666,69,"2,5",Zürich,8610,1550,1359,-191,-76,"19,7"
667,109,"4,5",Basel-Landschaft,4203,1940,1799,-141,-31,"16,5"
668,54,2,Solothurn,4143,1140,751,-389,-195,"13,9"
669,56,2,Basel-Stadt,4057,1290,1019,-271,-136,"18,2"
670,63,"3,5",Basel-Landschaft,4127,1610,1036,-574,-164,"16,45"
671,45,2,Basel-Stadt,4058,1220,819,-401,-201,"18,2"
672,52,2,Basel-Stadt,4058,1490,946,-544,-272,"18,2"
673,45,"1,5",Basel-Stadt,4058,1220,803,-417,-278,"17,85"
675,45,2,Basel-Stadt,4058,1300,819,-481,-241,"18,2"
677,100,"4,5",Waadt,1030,2495,1630,-865,-192,"16,3"
678,104,"5,5",Bern,3604,2210,1409,-801,-146,"13,55"
679,78,4,Aargau,4310,1670,1115,-555,-139,"14,3"
680,78,4,Aargau,4310,1750,1115,-635,-159,"14,3"
681,45,2,Basel-Landschaft,4053,1210,770,-440,-220,"17,1"
681,45,2,Basel-Stadt,4053,1210,819,-391,-196,"18,2"
682,83,"3,5",Thurgau,8522,1500,1108,-392,-112,"13,35"
683,67,"3,5",Solothurn,5012,1210,888,-322,-92,"13,25"
684,57,"2,5",Solothurn,5012,990,784,-206,-82,"13,75"
685,106,"4,5",Zug,6340,2320,1988,-332,-74,"18,75"
686,82,"4,5",Basel-Landschaft,4203,1480,1353,-127,-28,"16,5"
687,128,"4,5",Schwyz,8835,3700,2003,-1697,-377,"15,65"
690,135,"5,5",Zürich,8542,2800,2410,-390,-71,"17,85"
691,121,"4,5",Graubünden,7205,1950,1634,-316,-70,"13,5"
693,113,"4,5",Luzern,6207,1950,1599,-351,-78,"14,15"
696,36,"2,5",Freiburg,1635,1010,549,-461,-184,"15,25"
697,48,2,Zürich,8003,1853,994,-859,-430,"20,7"
698,101,"3,5",Zürich,8603,2250,1828,-422,-121,"18,1"
702,95,5,Genf,1203,3180,1758,-1422,-284,"18,5"
709,118,"3,5",Wallis,1941,1250,1564,314,90,"13,25"
710,35,"1,5",Wallis,1934,3150,565,-2585,-1723,"16,15"
711,16,1,Wallis,1934,725,278,-447,-447,"17,4"
712,89,3,Wallis,1906,1618,1237,-381,-127,"13,9"
713,70,3,Waadt,1400,1470,1197,-273,-91,"17,1"
714,108,"4,5",Waadt,1055,1980,1760,-220,-49,"16,3"
715,103,"3,5",Schwyz,6354,2200,1663,-537,-153,"16,15"
715,103,"3,5",Luzern,6354,2200,1524,-676,-193,"14,8"
716,87,"4,5",Luzern,6003,1900,1231,-669,-149,"14,15"
717,115,5,Luzern,6283,2140,1622,-518,-104,"14,1"
719,130,"4,5",Schwyz,8834,2790,2035,-755,-168,"15,65"
721,95,"3,5",Basel-Landschaft,4302,2630,1563,-1067,-305,"16,45"
722,110,"4,5",Aargau,5316,1600,1568,-32,-7,"14,25"
723,65,"2,5",Zürich,8600,1890,1281,-609,-244,"19,7"
724,79,"3,5",Basel-Landschaft,4053,1635,1300,-335,-96,"16,45"
724,79,"3,5",Basel-Stadt,4053,1635,1323,-312,-89,"16,75"
725,85,"4,5",Schaffhausen,8200,1820,1109,-711,-158,"13,05"
726,58,2,Schaffhausen,8200,1255,882,-373,-187,"15,2"
727,83,"3,5",Zürich,8404,1880,1502,-378,-108,"18,1"
728,51,"2,5",Basel-Landschaft,4053,1440,862,-578,-231,"16,9"
728,51,"2,5",Basel-Stadt,4053,1440,893,-547,-219,"17,5"
729,92,"4,5",Solothurn,4543,1550,1187,-363,-81,"12,9"
730,98,"4,5",Thurgau,8560,1530,1210,-320,-71,"12,35"
732,50,"2,5",Aargau,5004,1155,778,-377,-151,"15,55"
733,41,1,Bern,3007,1290,656,-634,-634,16
735,82,"3,5",Thurgau,8535,1700,1095,-605,-173,"13,35"
736,85,"4,5",Aargau,5603,1617,1211,-406,-90,"14,25"
737,23,1,Genf,1201,1240,453,-787,-787,"19,7"
738,68,"2,5",Aargau,5603,1495,1057,-438,-175,"15,55"
739,56,"2,5",Zürich,8152,1680,1103,-577,-231,"19,7"
740,104,"4,5",Zürich,8135,242,1825,1583,352,"17,55"
741,111,"3,5",Zürich,8910,2700,2009,-691,-197,"18,1"
742,146,"5,5",Zürich,8952,2900,2606,-294,-53,"17,85"
743,100,"4,5",Waadt,1022,2172,1630,-542,-120,"16,3"
744,28,1,Zürich,8052,960,610,-350,-350,"21,8"
746,56,"2,5",Zürich,8952,1690,1103,-587,-235,"19,7"
750,94,"4,5",Basel-Landschaft,4123,1930,1551,-379,-84,"16,5"
751,85,3,Waadt,1009,2195,1454,-741,-247,"17,1"
752,77,3,Waadt,1006,2445,1317,-1128,-376,"17,1"
755,83,"3,5",Basel-Stadt,4055,1510,1390,-120,-34,"16,75"
757,66,"2,5",Waadt,1020,1370,1168,-202,-81,"17,7"
758,88,"3,5",Waadt,1815,1850,1452,-398,-114,"16,5"
759,42,"1,5",Waadt,1033,970,832,-138,-92,"19,8"
760,23,1,Waadt,1020,725,490,-235,-235,"21,3"
761,100,"4,5",Freiburg,1754,1690,1350,-340,-76,"13,5"
762,82,4,Waadt,1860,1540,1304,-236,-59,"15,9"
763,44,2,Waadt,1800,1250,805,-445,-223,"18,3"
767,33,1,Zürich,8134,910,719,-191,-191,"21,8"
768,35,"1,5",Luzern,6353,1100,623,-477,-318,"17,8"
771,94,"3,5",Zürich,8046,2500,1701,-799,-228,"18,1"
772,96,"3,5",Zürich,8046,2650,1738,-912,-261,"18,1"
773,93,3,Freiburg,1633,1630,1376,-254,-85,"14,8"
774,29,1,Freiburg,1700,850,528,-322,-322,"18,2"
775,67,3,Neuchâtel,2000,1300,784,-516,-172,"11,7"
778,49,2,Zürich,8952,1540,1014,-526,-263,"20,7"
779,87,"3,5",Zürich,8952,2201,1575,-626,-179,"18,1"
780,130,"4,5",Luzern,6004,2235,1839,-396,-88,"14,15"
781,30,2,Genf,1201,1175,564,-611,-306,"18,8"
788,80,"2,5",Aargau,5622,1590,1244,-346,-138,"15,55"
795,77,4,Obwalden,6010,1471,1047,-424,-106,"13,6"
795,77,4,Nidwalden,6010,1471,1163,-308,-77,"15,1"
795,77,4,Luzern,6010,1471,1093,-378,-95,"14,2"
803,25,1,Waadt,1004,980,533,-447,-447,"21,3"
804,113,"4,5",Aargau,5330,2120,1610,-510,-113,"14,25"
805,102,4,Waadt,1052,2250,1622,-628,-157,"15,9"
810,105,"3,5",Zürich,8320,2085,1901,-184,-53,"18,1"
812,111,"4,5",Zürich,8620,2330,1948,-382,-85,"17,55"
815,68,"2,5",Bern,3110,1350,1010,-340,-136,"14,85"
816,51,"2,5",Luzern,6034,1240,821,-419,-168,"16,1"
816,51,"2,5",Aargau,6034,1240,793,-447,-179,"15,55"
817,73,"2,5",Zürich,8107,1780,1438,-342,-137,"19,7"
818,20,1,Genf,1205,1660,394,-1266,-1266,"19,7"
819,70,"3,5",Waadt,1290,2900,1155,-1745,-499,"16,5"
819,70,"3,5",Genf,1290,2900,1281,-1619,-463,"18,3"
821,128,"5,5",Zürich,8057,4525,2285,-2240,-407,"17,85"
826,30,1,Zürich,8044,1340,654,-686,-686,"21,8"
828,87,"3,5",Schwyz,8832,2223,1405,-818,-234,"16,15"
832,116,"3,5",Zürich,8712,1990,2100,110,31,"18,1"
833,110,"3,5",Aargau,5420,1800,1617,-183,-52,"14,7"
835,90,"3,5",Zürich,8810,3350,1629,-1721,-492,"18,1"
836,80,"3,5",Glarus,8867,1070,1016,-54,-15,"12,7"
837,100,"4,5",Solothurn,2544,1620,1290,-330,-73,"12,9"
838,91,"3,5",Thurgau,9320,1380,1215,-165,-47,"13,35"
839,67,"2,5",Luzern,6003,2080,1079,-1001,-400,"16,1"
840,89,"4,5",Solothurn,4562,1509,1148,-361,-80,"12,9"
841,78,"4,5",Glarus,8753,1260,944,-316,-70,"12,1"
842,39,"1,5",Waadt,1020,1190,772,-418,-279,"19,8"
844,94,"3,5",Zürich,8038,3550,1701,-1849,-528,"18,1"
845,49,"1,5",Luzern,6014,1170,872,-298,-199,"17,8"
846,98,"3,5",Zürich,8050,3330,1774,-1556,-445,"18,1"
847,111,"4,5",Zürich,8057,3685,1948,-1737,-386,"17,55"
848,121,"5,5",Zürich,8057,4290,2160,-2130,-387,"17,85"
849,128,"5,5",Zürich,8057,4525,2285,-2240,-407,"17,85"
850,105,"4,5",Zürich,8057,3505,1843,-1662,-369,"17,55"
851,60,2,Basel-Stadt,4057,1300,1092,-208,-104,"18,2"
853,120,"5,5",Zürich,8632,2050,2142,92,17,"17,85"
856,92,"3,5",St. Gallen,7310,1500,1274,-226,-65,"13,85"
857,60,"2,5",Zürich,8909,1390,1182,-208,-83,"19,7"
860,181,"4,5",Zürich,8700,5310,3177,-2133,-474,"17,55"
861,124,4,Zürich,8802,3500,2170,-1330,-333,"17,5"
862,110,"5,5",Zürich,8627,2400,1964,-436,-79,"17,85"
863,79,"2,5",Zürich,8810,1950,1556,-394,-158,"19,7"
864,111,"3,5",Zürich,8706,3610,2009,-1601,-457,"18,1"
865,116,"3,5",Zürich,8706,3780,2100,-1680,-480,"18,1"
866,257,"4,5",Zürich,8704,5800,4510,-1290,-287,"17,55"
868,110,"3,5",Zürich,8044,3160,1991,-1169,-334,"18,1"
869,99,"3,5",Zürich,8044,3300,1792,-1508,-431,"18,1"
870,109,"3,5",Zürich,8044,3160,1973,-1187,-339,"18,1"
871,156,"5,5",Zürich,8704,4000,2785,-1215,-221,"17,85"
872,233,"4,5",Zürich,8700,8000,4089,-3911,-869,"17,55"
874,80,"2,5",Zürich,8702,2825,1576,-1249,-500,"19,7"
875,103,"3,5",Zürich,8041,2825,1864,-961,-275,"18,1"
879,127,"4,5",Zürich,8041,3425,2229,-1196,-266,"17,55"
882,166,"3,5",Zürich,8008,5850,3005,-2845,-813,"18,1"
884,111,"5,5",Zürich,8132,2125,1981,-144,-26,"17,85"
885,170,"5,5",Zürich,8044,6800,3035,-3765,-685,"17,85"
886,20,1,Zürich,8304,1220,436,-784,-784,"21,8"
888,90,"3,5",Zürich,8632,1650,1629,-21,-6,"18,1"
889,68,"3,5",Solothurn,4528,1180,901,-279,-80,"13,25"
890,113,"5,5",Solothurn,5014,1650,1475,-175,-32,"13,05"
891,107,4,Bern,3097,2480,1509,-971,-243,"14,1"
892,88,"3,5",Bern,3053,1590,1258,-332,-95,"14,3"
893,97,"4,5",Bern,3053,2020,1343,-677,-150,"13,85"
896,50,2,Waadt,1423,740,915,175,88,"18,3"
897,62,"2,5",Zürich,8002,2905,1221,-1684,-674,"19,7"
899,64,"3,5",Zug,6300,2700,1226,-1474,-421,"19,15"
902,200,"4,5",Tessin,6850,2100,2770,670,149,"13,85"
903,43,2,Schwyz,8840,1250,765,-485,-243,"17,8"
904,100,"3,5",Freiburg,3186,1755,1415,-340,-97,"14,15"
905,90,"4,5",Bern,3292,1513,1247,-266,-59,"13,85"
906,62,"2,5",Zürich,8706,2550,1221,-1329,-532,"19,7"
907,110,"3,5",Zürich,8706,4300,1991,-2309,-660,"18,1"
908,80,4,Zürich,8488,1550,1400,-150,-38,"17,5"
909,70,3,Uri,6454,980,917,-63,-21,"13,1"
911,68,3,Obwalden,6010,1435,952,-483,-161,14
911,68,3,Nidwalden,6010,1435,1136,-299,-100,"16,7"
911,68,3,Luzern,6010,1435,1047,-388,-129,"15,4"
912,70,"3,5",Luzern,6045,1680,1036,-644,-184,"14,8"
913,47,2,Basel-Stadt,4056,2200,855,-1345,-673,"18,2"
914,93,"3,5",Zürich,8942,2530,1683,-847,-242,"18,1"
915,18,1,Zürich,8003,1150,392,-758,-758,"21,8"
916,18,1,Zürich,8003,1150,392,-758,-758,"21,8"
917,85,"4,5",Schaffhausen,8207,1395,1109,-286,-64,"13,05"
921,39,"2,5",Genf,1206,2000,727,-1273,-509,"18,65"
923,79,3,Basel-Landschaft,4132,1815,1319,-496,-165,"16,7"
924,40,"2,5",Schwyz,8840,1290,682,-608,-243,"17,05"
925,40,"1,5",Schwyz,8832,1590,714,-876,-584,"17,85"
926,99,"3,5",Zürich,8600,2114,1792,-322,-92,"18,1"
927,62,2,Basel-Stadt,4055,1570,1128,-442,-221,"18,2"
928,70,3,Solothurn,4500,1465,952,-513,-171,"13,6"
930,48,2,Aargau,4310,1016,768,-248,-124,16
931,68,3,Aargau,4310,1365,1027,-338,-113,"15,1"
932,35,1,Aargau,5300,890,571,-319,-319,"16,3"
933,89,"4,5",Bern,3422,1550,1233,-317,-70,"13,85"
934,97,"4,5",Zürich,8606,2105,1702,-403,-90,"17,55"
935,92,"4,5",Zürich,8405,1855,1615,-240,-53,"17,55"
939,56,"2,5",Waadt,1066,1350,991,-359,-144,"17,7"
941,82,"3,5",Freiburg,1680,1400,1160,-240,-69,"14,15"
943,50,2,Aargau,4310,1025,800,-225,-113,16
944,76,"3,5",Zürich,8623,1750,1376,-374,-107,"18,1"
946,50,2,Aargau,4310,1035,800,-235,-118,16
947,82,"3,5",Waadt,1018,2050,1353,-697,-199,"16,5"
950,102,"2,5",Nidwalden,6374,1780,1698,-82,-33,"16,65"
951,52,"2,5",Zürich,8002,1930,1024,-906,-362,"19,7"
952,210,"5,5",Bern,3703,2150,2846,696,127,"13,55"
953,50,2,Basel-Stadt,4056,984,910,-74,-37,"18,2"
956,90,4,Aargau,5610,1395,1287,-108,-27,"14,3"
957,84,4,Zürich,8909,1610,1470,-140,-35,"17,5"
958,73,"3,5",St. Gallen,9300,1220,1011,-209,-60,"13,85"
959,67,3,Bern,3172,1590,972,-618,-206,"14,5"
961,80,"3,5",Aargau,5325,1610,1176,-434,-124,"14,7"
962,75,2,Waadt,1263,1900,1373,-527,-264,"18,3"
965,68,"3,5",Zürich,8193,1880,1231,-649,-185,"18,1"
966,30,"1,5",Luzern,6033,875,534,-341,-227,"17,8"
968,54,"2,5",St. Gallen,9000,1140,805,-335,-134,"14,9"
970,85,"2,5",Aargau,5400,2200,1322,-878,-351,"15,55"
971,62,"2,5",Aargau,5400,2160,964,-1196,-478,"15,55"
972,106,"4,5",St. Gallen,8880,2000,1383,-617,-137,"13,05"
973,68,"3,5",Aargau,5400,2290,1000,-1290,-369,"14,7"
974,89,"3,5",Aargau,4914,1520,1308,-212,-61,"14,7"
974,89,"3,5",Bern,4914,1520,1273,-247,-71,"14,3"
975,85,"2,5",Aargau,5400,2320,1322,-998,-399,"15,55"
976,68,4,Luzern,6003,1300,966,-334,-84,"14,2"
978,75,"3,5",Zürich,8193,1890,1358,-532,-152,"18,1"
980,43,"1,5",Zürich,8053,1280,914,-366,-244,"21,25"
985,55,2,Waadt,1010,1200,1007,-193,-97,"18,3"
986,94,"4,5",Waadt,1028,1770,1532,-238,-53,"16,3"
987,54,2,Basel-Stadt,4055,1230,983,-247,-124,"18,2"
988,58,"2,5",Zug,6340,2400,1195,-1205,-482,"20,6"
989,74,3,Aargau,5723,1215,1117,-98,-33,"15,1"
996,100,"4,5",Zürich,8307,1890,1755,-135,-30,"17,55"
997,74,3,Aargau,5723,1095,1117,22,7,"15,1"
999,140,"4,5",Aargau,5723,1395,1995,600,133,"14,25"
1000,95,"3,5",Zürich,8610,2300,1720,-580,-166,"18,1"
1001,70,3,Zürich,8127,2320,1309,-1011,-337,"18,7"
1003,95,"4,5",Zürich,8127,2350,1667,-683,-152,"17,55"
1004,75,"3,5",Basel-Stadt,4054,1850,1256,-594,-170,"16,75"
1005,65,"2,5",Tessin,6952,1550,868,-682,-273,"13,35"
1007,78,"3,5",Luzern,6003,1760,1154,-606,-173,"14,8"
1008,53,2,Thurgau,8524,1350,763,-587,-294,"14,4"
1009,100,"2,5",Aargau,4316,1300,1555,255,102,"15,55"
1010,38,"1,5",Zürich,8002,1820,808,-1012,-675,"21,25"
1011,66,3,Zürich,8002,3200,1234,-1966,-655,"18,7"
1012,53,2,Zürich,8047,1575,1097,-478,-239,"20,7"
1013,56,"2,5",Aargau,5325,1350,871,-479,-192,"15,55"
1014,65,"2,5",Basel-Landschaft,4414,2060,1099,-961,-384,"16,9"
1015,110,"4,5",St. Gallen,7324,1920,1436,-484,-108,"13,05"
1016,48,2,Waadt,1804,1360,878,-482,-241,"18,3"
1018,64,3,Aargau,4800,1240,966,-274,-91,"15,1"
1020,78,"3,5",Waadt,1400,1752,1287,-465,-133,"16,5"
1021,69,"2,5",Schaffhausen,8240,1255,990,-265,-106,"14,35"
1024,16,1,Graubünden,7430,540,299,-241,-241,"18,7"
1025,33,1,Bern,3122,780,528,-252,-252,16
1026,109,"4,5",Basel-Landschaft,4417,2160,1799,-361,-80,"16,5"
1027,87,"3,5",Basel-Landschaft,4417,1920,1431,-489,-140,"16,45"
1028,45,2,St. Gallen,8645,1290,693,-597,-299,"15,4"
1030,28,1,Graubünden,7000,830,524,-306,-306,"18,7"
1031,120,"4,5",Schaffhausen,8200,2230,1566,-664,-148,"13,05"
1032,109,"4,5",St. Gallen,9464,1690,1422,-268,-60,"13,05"
1033,25,1,Graubünden,7031,650,468,-182,-182,"18,7"
1034,155,"4,5",Aargau,5644,1950,2209,259,58,"14,25"
1036,56,"2,5",St. Gallen,9451,1260,834,-426,-170,"14,9"
1038,172,"5,5",Zug,6312,4000,3543,-457,-83,"20,6"
1041,90,"4,5",St. Gallen,9200,1380,1175,-205,-46,"13,05"
1042,95,"4,5",Luzern,6102,1980,1344,-636,-141,"14,15"
1043,130,"5,5",St. Gallen,9445,1590,1632,42,8,"12,55"
1044,48,"2,5",Luzern,6003,1140,773,-367,-147,"16,1"
1048,110,"4,5",Glarus,8754,1860,1331,-529,-118,"12,1"
1049,65,3,Luzern,6006,1550,1001,-549,-183,"15,4"
1050,62,2,St. Gallen,9533,880,955,75,38,"15,4"
1051,72,"3,5",Basel-Landschaft,4447,1245,1184,-61,-17,"16,45"
1052,105,"4,5",Zug,6340,2600,1969,-631,-140,"18,75"
1054,97,"4,5",Bern,2504,1950,1343,-607,-135,"13,85"
1057,50,"2,5",Luzern,6280,1260,805,-455,-182,"16,1"
1059,80,4,Zürich,8245,1425,1400,-25,-6,"17,5"
1060,65,3,Zug,6343,1760,1268,-492,-164,"19,5"
1061,126,"4,5",Graubünden,7208,2100,1701,-399,-89,"13,5"
1062,75,"2,5",St. Gallen,9000,1460,1118,-342,-137,"14,9"
1063,25,1,St. Gallen,9443,630,398,-232,-232,"15,9"
1064,60,"1,5",Basel-Landschaft,4457,880,1023,143,95,"17,05"
1065,93,"3,5",Basel-Landschaft,4107,2400,1530,-870,-249,"16,45"
1066,85,"3,5",Basel-Landschaft,4127,2330,1398,-932,-266,"16,45"
1067,77,"2,5",Bern,3011,2600,1143,-1457,-583,"14,85"
1068,111,"3,5",Bern,3011,2990,1587,-1403,-401,"14,3"
1071,55,"2,5",Aargau,5703,1010,855,-155,-62,"15,55"
1072,82,4,Aargau,5223,1390,1173,-217,-54,"14,3"
1075,165,6,Graubünden,7208,2680,1964,-716,-119,"11,9"
1076,35,1,Graubünden,7504,875,655,-220,-220,"18,7"
1077,92,"4,5",St. Gallen,9016,1285,1201,-84,-19,"13,05"
1078,30,"1,5",Graubünden,7000,600,526,-74,-49,"17,55"
1079,55,3,Schwyz,6414,1190,897,-293,-98,"16,3"
1081,127,4,Luzern,6003,1580,1803,223,56,"14,2"
1082,100,"3,5",St. Gallen,9400,1850,1385,-465,-133,"13,85"
1085,230,6,Zürich,8800,5500,4163,-1337,-223,"18,1"
1086,69,4,Genf,1258,2350,1249,-1101,-275,"18,1"
1087,170,"3,5",Zürich,8143,2100,3077,977,279,"18,1"
1088,105,"3,5",Zürich,8038,3167,1901,-1266,-362,"18,1"
1089,80,"3,5",Tessin,6828,1400,1080,-320,-91,"13,5"
1091,46,"2,5",Zürich,8193,1680,906,-774,-310,"19,7"
1092,100,"3,5",Zürich,8700,3370,1810,-1560,-446,"18,1"
1093,45,2,Schaffhausen,8200,1040,684,-356,-178,"15,2"
1094,62,"3,5",Zürich,8193,1850,1122,-728,-208,"18,1"
1095,60,"2,5",Zürich,8193,1780,1182,-598,-239,"19,7"
1097,35,1,Bern,3095,940,560,-380,-380,16
1098,87,"3,5",Zürich,8193,1890,1575,-315,-90,"18,1"
1099,65,"2,5",Zürich,8038,1600,1281,-319,-128,"19,7"
1100,72,3,Luzern,6003,2090,1109,-981,-327,"15,4"
1101,116,"5,5",Aargau,5620,2110,1641,-469,-85,"14,15"
1102,85,"3,5",Luzern,6045,3500,1258,-2242,-641,"14,8"
1103,159,"5,5",Zürich,8942,3975,2838,-1137,-207,"17,85"
1104,21,1,Schwyz,8640,628,376,-252,-252,"17,9"
1104,21,1,St. Gallen,8640,628,334,-294,-294,"15,9"
1107,80,5,Genf,1212,2570,1480,-1090,-218,"18,5"
1108,82,"3,5",Waadt,1530,2140,1353,-787,-225,"16,5"
1111,35,2,Zürich,8004,1850,725,-1125,-563,"20,7"
1112,28,1,Zürich,8302,1050,610,-440,-440,"21,8"
1113,86,"3,5",Thurgau,8267,1890,1148,-742,-212,"13,35"
1114,83,"4,5",Thurgau,8267,1890,1025,-865,-192,"12,35"
1117,72,"2,5",Basel-Landschaft,4104,1780,1217,-563,-225,"16,9"
1119,50,4,Thurgau,9506,1210,640,-570,-143,"12,8"
1121,123,"4,5",Thurgau,8266,1970,1519,-451,-100,"12,35"
1125,60,"2,5",Waadt,1806,1400,1062,-338,-135,"17,7"
1126,90,4,Genf,1204,4000,1629,-2371,-593,"18,1"
1129,105,"4,5",Graubünden,7000,2170,1418,-752,-167,"13,5"
1130,107,"4,5",Bern,3098,1900,1482,-418,-93,"13,85"
1131,35,1,Zürich,8057,1220,763,-457,-457,"21,8"
1133,65,3,Luzern,6005,1740,1001,-739,-246,"15,4"
1135,58,"2,5",Waadt,1052,1765,1027,-738,-295,"17,7"
1136,172,"4,5",Zürich,8820,3175,3019,-156,-35,"17,55"
1137,92,"3,5",Zürich,8184,2320,1665,-655,-187,"18,1"
1138,127,"4,5",Luzern,6210,2230,1797,-433,-96,"14,15"
1139,67,3,Graubünden,7000,1275,1025,-250,-83,"15,3"
1140,58,3,Genf,1212,1820,1073,-747,-249,"18,5"
1141,35,2,St. Gallen,9000,800,539,-261,-131,"15,4"
1142,72,"3,5",Zürich,8820,1774,1303,-471,-135,"18,1"
1143,115,"3,5",Solothurn,4112,1820,1524,-296,-85,"13,25"
1144,76,4,Zürich,8046,1950,1330,-620,-155,"17,5"
1145,68,3,Bern,3014,1520,986,-534,-178,"14,5"
1146,100,"3,5",Jura,2830,900,1130,230,66,"11,3"
1147,71,"3,5",Waadt,1337,1200,1172,-28,-8,"16,5"
1148,55,"3,5",Zürich,8001,3990,996,-2994,-855,"18,1"
1153,83,4,Zürich,8708,2130,1453,-677,-169,"17,5"
1154,55,"2,5",Zürich,8953,1455,1084,-371,-148,"19,7"
1154,55,"2,5",Aargau,8953,1455,855,-600,-240,"15,55"
1155,140,"5,5",St. Gallen,9000,1970,1757,-213,-39,"12,55"
1156,16,1,Luzern,6004,550,301,-249,-249,"18,8"
1158,72,3,Waadt,1337,1020,1231,211,70,"17,1"
1161,26,"1,5",Luzern,6015,1200,463,-737,-491,"17,8"
1162,32,"1,5",Luzern,6015,1080,570,-510,-340,"17,8"
1163,58,"2,5",Zürich,8406,1720,1143,-577,-231,"19,7"
1164,69,3,Zürich,8610,1673,1290,-383,-128,"18,7"
1165,104,"4,5",Zürich,8623,2465,1825,-640,-142,"17,55"
1166,150,"3,5",Schaffhausen,8200,2395,1973,-422,-121,"13,15"
1168,75,"3,5",Zürich,8180,1839,1358,-481,-137,"18,1"
1169,88,"4,5",Bern,3604,1670,1219,-451,-100,"13,85"
1170,121,"4,5",Bern,2504,1840,1676,-164,-36,"13,85"
1171,64,"3,5",Bern,3700,1490,915,-575,-164,"14,3"
1172,32,1,Zürich,8952,845,698,-147,-147,"21,8"
1176,135,"3,5",Zürich,8425,1830,2444,614,175,"18,1"
1177,46,"1,5",Luzern,6020,830,819,-11,-7,"17,8"
1180,66,"2,5",Aargau,5400,2080,1026,-1054,-422,"15,55"
1181,65,"2,5",Aargau,5620,1180,1011,-169,-68,"15,55"
1183,105,5,Zürich,8942,1690,1848,158,32,"17,6"
1185,80,1,Zürich,8304,845,1744,899,899,"21,8"
1186,56,1,Zürich,8105,1380,1221,-159,-159,"21,8"
1187,116,"3,5",St. Gallen,9620,1700,1607,-93,-27,"13,85"
1188,164,"4,5",St. Gallen,9125,1690,2140,450,100,"13,05"
1190,65,3,Basel-Landschaft,4414,1172,1086,-86,-29,"16,7"
1191,94,"4,5",Basel-Landschaft,4450,1790,1551,-239,-53,"16,5"
1192,52,2,Basel-Landschaft,4410,1060,889,-171,-86,"17,1"
1193,76,"3,5",Basel-Landschaft,4153,1750,1250,-500,-143,"16,45"
1194,91,"4,5",Basel-Landschaft,4450,1645,1502,-143,-32,"16,5"
1195,22,1,Basel-Landschaft,4415,415,374,-41,-41,17
1196,111,"4,5",Basel-Landschaft,4410,2026,1832,-194,-43,"16,5"
1197,56,3,Basel-Landschaft,4410,1180,935,-245,-82,"16,7"
1198,50,"2,5",Basel-Landschaft,4410,1445,845,-600,-240,"16,9"
1199,103,"4,5",Basel-Landschaft,4455,1870,1700,-170,-38,"16,5"
1200,80,3,Basel-Landschaft,4123,1670,1336,-334,-111,"16,7"
1201,85,"3,5",Solothurn,5015,1590,1126,-464,-133,"13,25"
1203,65,"2,5",Luzern,6032,1410,1047,-363,-145,"16,1"
1204,83,"3,5",Luzern,6032,1710,1228,-482,-138,"14,8"
1205,160,"3,5",Luzern,6102,2670,2368,-302,-86,"14,8"
1206,111,"3,5",Luzern,6289,1500,1643,143,41,"14,8"
1208,93,"4,5",Zürich,8618,2140,1632,-508,-113,"17,55"
1210,159,"5,5",Waadt,1271,3190,2703,-487,-89,17
1212,84,4,St. Gallen,9220,1215,1117,-98,-25,"13,3"
1212,84,4,Thurgau,9220,1215,1075,-140,-35,"12,8"
1213,70,"2,5",Appenzell Ausserrhoden,9113,1380,973,-407,-163,"13,9"
1213,70,"2,5",St. Gallen,9113,1380,1043,-337,-135,"14,9"
1214,67,"3,5",Bern,3302,1354,958,-396,-113,"14,3"
1216,123,"3,5",Genf,1246,7050,2251,-4799,-1371,"18,3"
1217,104,"4,5",Basel-Stadt,4059,2415,1768,-647,-144,17
1218,85,"3,5",Waadt,1025,2800,1403,-1397,-399,"16,5"
1220,58,2,Waadt,1020,1390,1061,-329,-165,"18,3"
1222,127,4,Luzern,6003,1580,1803,223,56,"14,2"
1223,97,"3,5",Zürich,8408,1885,1756,-129,-37,"18,1"
1225,77,"3,5",Aargau,5210,1665,1132,-533,-152,"14,7"
1227,47,"1,5",Schaffhausen,8200,1340,632,-708,-472,"13,45"
1228,107,"4,5",Waadt,1000,3020,1744,-1276,-284,"16,3"
1231,61,"1,5",Basel-Landschaft,4106,850,1040,190,127,"17,05"
1232,76,3,Zürich,8001,3190,1421,-1769,-590,"18,7"
1234,136,5,Basel-Stadt,4051,3480,2353,-1127,-225,"17,3"
1235,81,"3,5",Zürich,8005,2630,1466,-1164,-333,"18,1"
1238,145,"5,5",Aargau,5600,3100,2052,-1048,-191,"14,15"
1239,75,3,Schwyz,8840,1700,1223,-477,-159,"16,3"
1240,125,"4,5",Zürich,8489,1900,2194,294,65,"17,55"
1243,195,"5,5",Zürich,8610,3600,3481,-119,-22,"17,85"
1244,50,2,Basel-Stadt,4056,1170,910,-260,-130,"18,2"
1245,84,"3,5",Luzern,6206,1880,1243,-637,-182,"14,8"
1247,110,"4,5",Luzern,6006,2560,1556,-1004,-223,"14,15"
1250,45,"2,5",St. Gallen,9230,950,671,-279,-112,"14,9"
1251,102,"4,5",Zürich,8006,3192,1790,-1402,-312,"17,55"
1253,118,"3,5",St. Gallen,8722,2400,1634,-766,-219,"13,85"
1254,78,"4,5",St. Gallen,8737,1380,1018,-362,-80,"13,05"
1256,90,3,Waadt,1020,2420,1539,-881,-294,"17,1"
1259,103,"3,5",Thurgau,9315,1750,1375,-375,-107,"13,35"
1259,103,"3,5",St. Gallen,9315,1750,1427,-323,-92,"13,85"
1261,86,"3,5",St. Gallen,9212,1430,1191,-239,-68,"13,85"
1262,106,"4,5",Schaffhausen,8213,1380,1383,3,1,"13,05"
1263,52,"2,5",St. Gallen,9400,1100,775,-325,-130,"14,9"
1265,104,"5,5",Thurgau,8580,1530,1232,-298,-54,"11,85"
1265,104,"5,5",St. Gallen,8580,1530,1305,-225,-41,"12,55"
1267,138,"4,5",St. Gallen,9244,2230,1801,-429,-95,"13,05"
1268,30,1,St. Gallen,9242,850,477,-373,-373,"15,9"
1269,106,"4,5",Obwalden,6074,1865,1399,-466,-104,"13,2"
1270,114,"4,5",Schwyz,8852,2400,1784,-616,-137,"15,65"
1271,117,"4,5",Solothurn,4600,1950,1509,-441,-98,"12,9"
1271,117,"4,5",Aargau,4600,1950,1667,-283,-63,"14,25"
1273,90,3,Basel-Stadt,4125,2380,1512,-868,-289,"16,8"
1274,57,2,Basel-Stadt,4054,1520,1037,-483,-242,"18,2"
1277,120,4,Zürich,8008,2570,2100,-470,-118,"17,5"
1279,93,"4,5",Bern,1595,1500,1288,-212,-47,"13,85"
1279,93,"4,5",Waadt,1595,1500,1516,16,4,"16,3"
1293,51,"1,5",St. Gallen,8733,1310,798,-512,-341,"15,65"
1294,65,"1,5",Zürich,8700,2020,1381,-639,-426,"21,25"
1295,90,"3,5",Zug,6330,2800,1723,-1077,-308,"19,15"
1296,100,"4,5",Zürich,8002,2300,1755,-545,-121,"17,55"
1298,90,"4,5",St. Gallen,8725,1430,1175,-255,-57,"13,05"
1301,80,"4,5",St. Gallen,9430,1200,1044,-156,-35,"13,05"
1303,19,1,Zürich,8304,1050,414,-636,-636,"21,8"
1315,180,"5,5",Aargau,5033,2200,2547,347,63,"14,15"
1316,100,"3,5",Aargau,5033,1900,1470,-430,-123,"14,7"
1317,77,3,Basel-Stadt,4126,1560,1294,-266,-89,"16,8"
1318,120,"4,5",Aargau,5412,1750,1710,-40,-9,"14,25"
1321,80,3,Bern,3008,1500,1160,-340,-113,"14,5"
1324,80,"3,5",St. Gallen,8636,1700,1108,-592,-169,"13,85"
1324,80,"3,5",Zürich,8636,1700,1448,-252,-72,"18,1"
1354,90,3,Aargau,4853,1980,1359,-621,-207,"15,1"
1354,90,3,Bern,4853,1980,1305,-675,-225,"14,5"
1355,60,"2,5",Thurgau,8512,1350,849,-501,-200,"14,15"
1357,85,"3,5",Neuchâtel,2300,1600,1016,-584,-167,"11,95"
1360,93,"3,5",Thurgau,8500,2320,1242,-1078,-308,"13,35"
1360,93,"3,5",Zürich,8500,2320,1683,-637,-182,"18,1"
1365,50,2,Aargau,4665,911,800,-111,-56,16
1369,140,"5,5",Zug,6332,3350,2884,-466,-85,"20,6"
1370,80,"4,5",Thurgau,9320,1450,988,-462,-103,"12,35"
1371,50,2,Graubünden,7277,1000,820,-180,-90,"16,4"
1372,117,"4,5",Graubünden,7013,1840,1580,-260,-58,"13,5"
1374,60,"2,5",Graubünden,7000,1305,951,-354,-142,"15,85"
1376,44,"2,5",Luzern,6043,1400,708,-692,-277,"16,1"
1377,83,3,Luzern,6026,1800,1278,-522,-174,"15,4"
1378,65,3,Bern,3422,1150,943,-207,-69,"14,5"
1379,50,"2,5",Luzern,6110,1100,805,-295,-118,"16,1"
1381,100,"2,5",Bern,3013,2290,1485,-805,-322,"14,85"
1382,32,2,Luzern,6000,990,538,-452,-226,"16,8"
1383,129,"4,5",Basel-Landschaft,4436,1750,2129,379,84,"16,5"
1384,125,"5,5",Graubünden,7130,1855,1506,-349,-63,"12,05"
1386,80,"4,5",Bern,3600,1690,1108,-582,-129,"13,85"
1389,28,1,Luzern,6030,850,526,-324,-324,"18,8"
1390,105,"3,5",Luzern,6232,1950,1554,-396,-113,"14,8"
1392,110,4,Waadt,1291,3400,1749,-1651,-413,"15,9"
1393,161,6,Genf,1218,4180,3639,-541,-90,"22,6"
1394,200,6,Genf,1233,4600,4520,-80,-13,"22,6"
1395,76,"3,5",Waadt,1066,2210,1254,-956,-273,"16,5"
1396,75,3,Genf,1204,2490,1388,-1102,-367,"18,5"
1397,38,"1,5",Genf,1206,1415,732,-683,-455,"19,25"
1398,75,3,Genf,1202,3500,1388,-2112,-704,"18,5"
1400,35,"1,5",Aargau,5022,925,565,-360,-240,"16,15"
1403,82,"4,5",Zürich,8620,1890,1439,-451,-100,"17,55"
1407,125,"4,5",St. Gallen,8892,1600,1631,31,7,"13,05"
1440,92,"3,5",St. Gallen,8880,1690,1274,-416,-119,"13,85"
1443,115,"4,5",St. Gallen,8888,2100,1501,-599,-133,"13,05"
1448,121,"4,5",St. Gallen,7324,1790,1579,-211,-47,"13,05"
1449,102,"4,5",St. Gallen,8880,2210,1331,-879,-195,"13,05"
1452,92,"3,5",St. Gallen,7323,1860,1274,-586,-167,"13,85"
1459,105,"3,5",St. Gallen,8888,2360,1454,-906,-259,"13,85"
1460,98,"3,5",St. Gallen,8888,1820,1357,-463,-132,"13,85"
1462,83,4,Schaffhausen,8200,1390,1062,-328,-82,"12,8"
1463,121,"4,5",Zürich,8707,3100,2124,-976,-217,"17,55"
1464,90,"3,5",Aargau,5300,2325,1323,-1002,-286,"14,7"
1466,72,"3,5",Basel-Landschaft,4053,1980,1184,-796,-227,"16,45"
1466,72,"3,5",Basel-Stadt,4053,1980,1206,-774,-221,"16,75"
1467,85,4,St. Gallen,8733,1575,1131,-444,-111,"13,3"
1471,115,"3,5",Bern,3144,1800,1645,-155,-44,"14,3"
1476,160,6,St. Gallen,9533,2000,1968,-32,-5,"12,3"
1477,73,"3,5",Bern,3073,1563,1044,-519,-148,"14,3"
1478,95,4,Bern,2502,1700,1340,-360,-90,"14,1"
1479,24,1,Bern,3012,750,384,-366,-366,16
1481,74,"3,5",Bern,3700,1390,1058,-332,-95,"14,3"
1483,30,1,Bern,3116,950,480,-470,-470,16
1487,90,"4,5",Bern,3645,1740,1247,-493,-110,"13,85"
1488,80,"3,5",Bern,3862,1000,1144,144,41,"14,3"
1492,28,1,Bern,3014,870,448,-422,-422,16
1494,65,3,St. Gallen,9000,725,936,211,70,"14,4"
1497,70,"2,5",Basel-Stadt,4001,2325,1225,-1100,-440,"17,5"
1498,70,3,Basel-Stadt,4001,2850,1176,-1674,-558,"16,8"
1499,148,6,Basel-Stadt,4051,4950,2827,-2123,-354,"19,1"
1500,96,"3,5",Waadt,1041,1710,1584,-126,-36,"16,5"
1502,78,"3,5",Waadt,1004,1950,1287,-663,-189,"16,5"
1503,75,3,Genf,1204,2640,1388,-1252,-417,"18,5"
1505,100,"3,5",Waadt,1860,1650,1650,0,0,"16,5"
1506,18,1,St. Gallen,9008,500,286,-214,-214,"15,9"
1510,105,4,Graubünden,7205,1948,1554,-394,-99,"14,8"
1511,60,3,Zürich,8004,2500,1122,-1378,-459,"18,7"
1514,100,"4,5",Thurgau,9325,1800,1235,-565,-126,"12,35"
1517,131,"4,5",Thurgau,8280,2100,1618,-482,-107,"12,35"
1519,71,4,Graubünden,7403,1123,1051,-72,-18,"14,8"
1520,110,"4,5",Thurgau,8507,1700,1359,-341,-76,"12,35"
1521,45,"1,5",Basel-Landschaft,4053,1450,767,-683,-455,"17,05"
1521,45,"1,5",Basel-Stadt,4053,1450,803,-647,-431,"17,85"
1522,80,"3,5",Graubünden,7430,1170,1204,34,10,"15,05"
1523,65,2,Appenzell Innerrhoden,9450,900,728,-172,-86,"11,2"
1523,65,2,Appenzell Ausserrhoden,9450,900,975,75,38,15
1523,65,2,St. Gallen,9450,900,1001,101,51,"15,4"
1524,50,2,St. Gallen,9200,980,770,-210,-105,"15,4"
1525,116,"4,5",Graubünden,7000,2110,1566,-544,-121,"13,5"
1526,95,"3,5",Graubünden,7082,2150,1430,-720,-206,"15,05"
1527,65,3,St. Gallen,8873,1350,936,-414,-138,"14,4"
1528,102,"4,5",Basel-Landschaft,4414,2295,1683,-612,-136,"16,5"
1529,72,3,Luzern,6004,1990,1109,-881,-294,"15,4"
1539,80,4,St. Gallen,9602,1280,1064,-216,-54,"13,3"
1540,50,"2,5",St. Gallen,9230,980,745,-235,-94,"14,9"
1541,130,"4,5",St. Gallen,9607,1720,1697,-23,-5,"13,05"
1544,64,"3,5",Obwalden,6060,1480,883,-597,-171,"13,8"
1545,75,3,Basel-Stadt,4056,1670,1260,-410,-137,"16,8"
1549,38,"1,5",St. Gallen,9008,720,595,-125,-83,"15,65"
1550,35,1,Waadt,1010,1140,746,-394,-394,"21,3"
1551,45,1,Appenzell Ausserrhoden,9428,550,743,193,193,"16,5"
1551,45,1,St. Gallen,9428,550,716,166,166,"15,9"
1551,45,1,Appenzell Innerrhoden,9428,550,702,152,152,"15,6"
1552,100,3,Thurgau,8570,1600,1390,-210,-70,"13,9"
1554,77,"3,5",Graubünden,7418,1190,1159,-31,-9,"15,05"
1555,69,"2,5",St. Gallen,9032,1510,1028,-482,-193,"14,9"
1556,74,"2,5",Zürich,8820,2040,1458,-582,-233,"19,7"
1557,50,2,Aargau,5000,1250,800,-450,-225,16
1559,123,"4,5",Schwyz,6430,2488,1925,-563,-125,"15,65"
1560,30,1,Zürich,8051,1090,654,-436,-436,"21,8"
1561,70,"2,5",Basel-Landschaft,4242,1260,1183,-77,-31,"16,9"
1565,64,"3,5",Luzern,6003,1850,947,-903,-258,"14,8"
1567,74,"3,5",Zürich,8134,1950,1339,-611,-175,"18,1"
1568,80,"3,5",Appenzell Ausserrhoden,9053,1320,1020,-300,-86,"12,75"
1568,80,"3,5",Appenzell Innerrhoden,9053,1320,1120,-200,-57,14
1569,60,"2,5",Zug,6314,1630,1236,-394,-158,"20,6"
1570,117,"5,5",Thurgau,9215,1450,1386,-64,-12,"11,85"
1571,104,"4,5",St. Gallen,9312,1650,1357,-293,-65,"13,05"
1574,60,2,St. Gallen,8716,1140,924,-216,-108,"15,4"
1575,80,"3,5",Thurgau,8272,1447,1068,-379,-108,"13,35"
1576,140,"3,5",Thurgau,8272,1650,1869,219,63,"13,35"
1577,30,1,Basel-Landschaft,4053,1270,510,-760,-760,17
1577,30,1,Basel-Stadt,4053,1270,525,-745,-745,"17,5"
1579,70,"3,5",Basel-Landschaft,4127,1450,1152,-298,-85,"16,45"
1580,69,3,Basel-Landschaft,4132,1470,1152,-318,-106,"16,7"
1581,70,3,Basel-Landschaft,4052,1470,1169,-301,-100,"16,7"
1581,70,3,Basel-Stadt,4052,1470,1176,-294,-98,"16,8"
1631,120,"4,5",St. Gallen,9443,1985,1566,-419,-93,"13,05"
1632,75,"3,5",Aargau,5734,1280,1103,-177,-51,"14,7"
1633,80,"3,5",Graubünden,7403,1380,1204,-176,-50,"15,05"
1634,130,5,Luzern,6006,3300,1833,-1467,-293,"14,1"
1635,150,"5,5",Wallis,3968,2000,2010,10,2,"13,4"
1636,91,"3,5",St. Gallen,9445,1470,1260,-210,-60,"13,85"
1637,82,"3,5",Basel-Landschaft,4414,1460,1349,-111,-32,"16,45"
1638,122,"4,5",Zug,6315,2900,2288,-612,-136,"18,75"
1638,122,"4,5",Schwyz,6315,2900,1909,-991,-220,"15,65"
1641,79,4,St. Gallen,9030,1540,1051,-489,-122,"13,3"
1645,128,"4,5",Solothurn,2540,2000,1651,-349,-78,"12,9"
1648,105,4,Waadt,1148,1980,1670,-310,-78,"15,9"
1655,80,"4,5",Schwyz,8855,1550,1252,-298,-66,"15,65"
1657,80,"3,5",Basel-Stadt,4056,2900,1340,-1560,-446,"16,75"
1663,55,"2,5",Tessin,6613,1500,734,-766,-306,"13,35"
1666,139,6,Zürich,8309,3800,2516,-1284,-214,"18,1"
1667,91,"3,5",St. Gallen,9445,1440,1260,-180,-51,"13,85"
1669,103,"3,5",Waadt,1350,1800,1700,-100,-29,"16,5"
1671,105,4,St. Gallen,9602,1520,1397,-123,-31,"13,3"
1672,106,"4,5",Schwyz,8854,2415,1659,-756,-168,"15,65"
1673,90,"3,5",Schwyz,6443,1400,1453,53,15,"16,15"
1678,100,5,Thurgau,9500,1850,1190,-660,-132,"11,9"
1678,100,5,St. Gallen,9500,1850,1280,-570,-114,"12,8"
1679,60,3,Waadt,1880,900,1026,126,42,"17,1"
1680,110,"4,5",Luzern,6022,1200,1556,356,79,"14,15"
1682,128,"4,5",Solothurn,2540,2000,1651,-349,-78,"12,9"
1683,180,"4,5",Waadt,1358,2250,2934,684,152,"16,3"
1684,67,2,Wallis,1897,1500,998,-502,-251,"14,9"
1689,120,"4,5",Genf,1202,4500,2196,-2304,-512,"18,3"
1690,103,"4,5",Bern,2720,1500,1427,-73,-16,"13,85"
1694,46,2,St. Gallen,8636,1195,708,-487,-244,"15,4"
1694,46,2,Zürich,8636,1195,952,-243,-122,"20,7"
1695,127,4,Neuchâtel,2024,2600,1549,-1051,-263,"12,2"
1696,105,"5,5",Aargau,5082,2200,1486,-714,-130,"14,15"
1698,90,"3,5",Basel-Landschaft,4494,1350,1481,131,37,"16,45"
1699,150,"4,5",Basel-Landschaft,4147,2950,2475,-475,-106,"16,5"
1700,110,4,Freiburg,1475,1528,1485,-43,-11,"13,5"
1702,115,"4,5",Waadt,1009,3385,1875,-1510,-336,"16,3"
1703,80,"3,5",Neuchâtel,2300,1050,956,-94,-27,"11,95"
1705,119,"2,5",Zürich,8610,2490,2344,-146,-58,"19,7"
1706,96,"4,5",Uri,6460,1495,1219,-276,-61,"12,7"
1708,100,"4,5",Bern,2610,1290,1385,95,21,"13,85"
1710,170,"5,5",Waadt,1853,2450,2890,440,80,17
1711,78,"2,5",Schwyz,8854,1955,1330,-625,-250,"17,05"
1715,152,"4,5",Waadt,2108,1850,2478,628,140,"16,3"
1715,152,"4,5",Neuchâtel,2108,1850,1892,42,9,"12,45"
1716,72,"3,5",Waadt,1148,1550,1188,-362,-103,"16,5"
1720,125,"5,5",Bern,3856,1520,1694,174,32,"13,55"
1721,65,"2,5",Waadt,1867,1570,1151,-419,-168,"17,7"
1722,120,4,Neuchâtel,2054,1650,1464,-186,-47,"12,2"
1726,125,"4,5",Schaffhausen,8213,1490,1631,141,31,"13,05"
1727,139,"4,5",Appenzell Ausserrhoden,9527,2290,1703,-587,-130,"12,25"
1727,139,"4,5",St. Gallen,9527,2290,1814,-476,-106,"13,05"
1732,120,"4,5",St. Gallen,9477,1650,1566,-84,-19,"13,05"
1733,80,"4,5",Bern,2610,1100,1108,8,2,"13,85"
1734,105,"4,5",St. Gallen,8636,2412,1370,-1042,-232,"13,05"
1734,105,"4,5",Zürich,8636,2412,1843,-569,-126,"17,55"
1735,250,6,St. Gallen,9220,2500,3075,575,96,"12,3"
1735,250,6,Thurgau,9220,2500,2950,450,75,"11,8"
1737,160,"2,5",Waadt,1185,2740,2832,92,37,"17,7"
1745,160,5,Waadt,1822,2900,2672,-228,-46,"16,7"
1747,102,"3,5",Nidwalden,6375,2400,1622,-778,-222,"15,9"
1749,55,"2,5",Bern,3122,1200,817,-383,-153,"14,85"
1750,85,"3,5",Bern,3380,1510,1216,-294,-84,"14,3"
1757,79,"3,5",Aargau,5600,1705,1161,-544,-155,"14,7"
1758,50,2,Aargau,5615,900,800,-100,-50,16
1759,63,3,Aargau,4665,1460,951,-509,-170,"15,1"
1760,91,"3,5",Aargau,8916,1820,1338,-482,-138,"14,7"
1761,70,"2,5",Tessin,6822,750,935,185,74,"13,35"
1762,80,4,Zürich,8134,1750,1400,-350,-88,"17,5"
1763,117,"4,5",Aargau,5032,1955,1667,-288,-64,"14,25"
1764,90,"3,5",Zürich,8610,2470,1629,-841,-240,"18,1"
1765,140,1,Aargau,5032,2090,2282,192,192,"16,3"
1766,66,"2,5",Zürich,8050,1780,1300,-480,-192,"19,7"
1767,121,"5,5",Thurgau,8360,1977,1434,-543,-99,"11,85"
1768,37,1,St. Gallen,9244,640,588,-52,-52,"15,9"
1769,62,"3,5",St. Gallen,9000,1090,859,-231,-66,"13,85"
1770,78,"3,5",St. Gallen,9200,1520,1080,-440,-126,"13,85"
1772,83,"3,5",Bern,2502,1860,1187,-673,-192,"14,3"
1773,74,"3,5",Thurgau,8280,1525,988,-537,-153,"13,35"
1774,48,2,Zürich,8623,1230,994,-236,-118,"20,7"
1775,61,3,Bern,3800,1450,885,-565,-188,"14,5"
1777,82,"3,5",Zürich,8048,2303,1484,-819,-234,"18,1"
1779,140,"5,5",Zug,6332,3350,2884,-466,-85,"20,6"
1780,80,"4,5",Thurgau,9320,1450,988,-462,-103,"12,35"
1781,115,"4,5",Freiburg,1532,2260,1553,-707,-157,"13,5"
1784,140,"5,5",Waadt,1303,2600,2380,-220,-40,17
1785,155,"5,5",Freiburg,1725,2600,2108,-492,-89,"13,6"
1786,125,"4,5",Basel-Landschaft,4447,2000,2063,63,14,"16,5"
1788,73,"4,5",Jura,2800,1140,752,-388,-86,"10,3"
1790,100,"3,5",Waadt,1820,2350,1650,-700,-200,"16,5"
1792,83,"3,5",Aargau,5417,1590,1220,-370,-106,"14,7"
1793,57,"2,5",Basel-Stadt,4054,1520,998,-522,-209,"17,5"
1794,90,"3,5",Basel-Stadt,4125,2380,1508,-872,-249,"16,75"
1795,52,2,Waadt,1800,1215,952,-263,-132,"18,3"
1798,129,"5,5",Waadt,1170,2850,2193,-657,-119,17
1801,100,3,Waadt,1170,2180,1710,-470,-157,"17,1"
1803,100,"3,5",Tessin,6612,2200,1350,-850,-243,"13,5"
1804,74,"3,5",Tessin,6653,1600,999,-601,-172,"13,5"
1805,82,"3,5",Tessin,6648,2000,1107,-893,-255,"13,5"
1806,55,"2,5",Tessin,6612,1480,734,-746,-298,"13,35"
1807,125,"4,5",Tessin,6616,2300,1731,-569,-126,"13,85"
1808,100,"4,5",Tessin,6612,2580,1385,-1195,-266,"13,85"
1810,88,4,Tessin,6600,1500,1188,-312,-78,"13,5"
1811,100,"4,5",Tessin,6900,1580,1385,-195,-43,"13,85"
1812,60,"2,5",Tessin,6900,1200,801,-399,-160,"13,35"
1813,182,"4,5",Zürich,8004,6500,3194,-3306,-735,"17,55"
1816,80,"3,5",St. Gallen,9300,1250,1108,-142,-41,"13,85"
1817,87,"3,5",Tessin,6600,1860,1175,-685,-196,"13,5"
1818,102,"4,5",Bern,3067,2130,1413,-717,-159,"13,85"
1819,99,"4,5",Bern,3322,1700,1371,-329,-73,"13,85"
1825,82,"3,5",Thurgau,9322,1710,1095,-615,-176,"13,35"
1826,93,"3,5",Thurgau,8500,1590,1242,-348,-99,"13,35"
1826,93,"3,5",Zürich,8500,1590,1683,93,27,"18,1"
1827,79,4,Waadt,1530,1270,1256,-14,-4,"15,9"
1828,56,2,Waadt,1814,1096,1025,-71,-36,"18,3"
1829,91,3,Aargau,5036,1385,1374,-11,-4,"15,1"
1830,113,"4,5",Aargau,5400,2890,1610,-1280,-284,"14,25"
1831,109,"4,5",Aargau,5400,2560,1553,-1007,-224,"14,25"
1832,79,3,Zürich,8050,2260,1477,-783,-261,"18,7"
1833,262,"3,5",Basel-Landschaft,4123,1550,4310,2760,789,"16,45"
1834,121,"4,5",St. Gallen,9606,1960,1579,-381,-85,"13,05"
1837,90,"4,5",Zürich,8810,2429,1580,-849,-189,"17,55"
1838,10,1,Aargau,5073,450,163,-287,-287,"16,3"
1840,88,"3,5",Zürich,8126,2080,1593,-487,-139,"18,1"
1841,88,"4,5",Zürich,8135,1810,1544,-266,-59,"17,55"
1842,100,"4,5",Solothurn,4612,1490,1290,-200,-44,"12,9"
1843,66,3,Zürich,8135,1420,1234,-186,-62,"18,7"
1844,90,"3,5",Bern,3013,1900,1287,-613,-175,"14,3"
1848,62,3,Basel-Landschaft,4123,1450,1035,-415,-138,"16,7"
1849,98,"4,5",Solothurn,4612,1655,1264,-391,-87,"12,9"
1850,76,"3,5",Zürich,8135,1575,1376,-199,-57,"18,1"
1853,100,"3,5",Waadt,1860,1650,1650,0,0,"16,5"
1854,102,4,Aargau,5222,1650,1459,-191,-48,"14,3"
1855,49,2,Zürich,8050,1530,1014,-516,-258,"20,7"
1856,60,"2,5",Waadt,1453,1100,1062,-38,-15,"17,7"
1857,60,"3,5",Waadt,1453,990,990,0,0,"16,5"
1858,61,"2,5",Solothurn,4623,1340,839,-501,-200,"13,75"
1867,85,"3,5",Bern,3063,1647,1216,-431,-123,"14,3"
1868,106,"5,5",Bern,3110,1660,1436,-224,-41,"13,55"
1869,73,"2,5",Zürich,8048,1950,1438,-512,-205,"19,7"
1870,100,"3,5",Zürich,8954,3330,1810,-1520,-434,"18,1"
1871,80,3,Zürich,8954,2400,1496,-904,-301,"18,7"
1872,79,3,Zürich,8954,2350,1477,-873,-291,"18,7"
1873,30,1,Appenzell Innerrhoden,9450,670,468,-202,-202,"15,6"
1873,30,1,Appenzell Ausserrhoden,9450,670,495,-175,-175,"16,5"
1873,30,1,St. Gallen,9450,670,477,-193,-193,"15,9"
1874,63,"2,5",Waadt,1400,1480,1115,-365,-146,"17,7"
1875,110,"4,5",Thurgau,8500,1690,1359,-331,-74,"12,35"
1875,110,"4,5",Zürich,8500,1690,1931,241,54,"17,55"
1876,61,3,Zürich,8952,1590,1141,-449,-150,"18,7"
1877,76,"3,5",Freiburg,1630,1670,1075,-595,-170,"14,15"
1879,16,1,Basel-Stadt,4055,420,280,-140,-140,"17,5"
1880,36,1,Waadt,1852,950,767,-183,-183,"21,3"
1882,128,"4,5",Basel-Stadt,4054,3500,2176,-1324,-294,17
1883,117,"4,5",Aargau,5600,2915,1667,-1248,-277,"14,25"
1884,28,1,Aargau,5742,1060,456,-604,-604,"16,3"
1885,100,4,Bern,3123,1995,1410,-585,-146,"14,1"
1887,54,3,Waadt,1844,1250,923,-327,-109,"17,1"
1888,60,"2,5",Zürich,8606,1875,1182,-693,-277,"19,7"
1889,85,4,Thurgau,8500,1630,1088,-542,-136,"12,8"
1889,85,4,Zürich,8500,1630,1488,-142,-36,"17,5"
1890,97,"3,5",Freiburg,1762,1660,1373,-287,-82,"14,15"
1891,93,"4,5",Solothurn,4600,1575,1200,-375,-83,"12,9"
1891,93,"4,5",Aargau,4600,1575,1325,-250,-56,"14,25"
1892,118,"4,5",Basel-Landschaft,4147,2720,1947,-773,-172,"16,5"
1893,61,"2,5",Freiburg,1482,1205,930,-275,-110,"15,25"
1894,45,"2,5",St. Gallen,9000,1040,671,-369,-148,"14,9"
1895,73,"2,5",Zürich,8152,1935,1438,-497,-199,"19,7"
1896,70,"2,5",Zürich,8152,2052,1379,-673,-269,"19,7"
1897,57,2,Freiburg,1700,1195,895,-300,-150,"15,7"
1898,98,"4,5",Basel-Landschaft,4123,2370,1617,-753,-167,"16,5"
1899,99,"3,5",Bern,2503,1950,1416,-534,-153,"14,3"
1900,94,"4,5",Bern,3053,2000,1302,-698,-155,"13,85"
1902,55,"2,5",Freiburg,1700,1425,839,-586,-234,"15,25"
1908,172,"5,5",Thurgau,8555,2800,2038,-762,-139,"11,85"
1909,172,"5,5",Thurgau,8556,2800,2038,-762,-139,"11,85"
1910,109,"4,5",Obwalden,6010,2630,1439,-1191,-265,"13,2"
1910,109,"4,5",Nidwalden,6010,2630,1635,-995,-221,15
1910,109,"4,5",Luzern,6010,2630,1542,-1088,-242,"14,15"
1911,87,"4,5",Basel-Stadt,4058,2450,1479,-971,-216,17
1912,55,"3,5",Basel-Stadt,4058,2250,921,-1329,-380,"16,75"
1913,87,"4,5",Basel-Stadt,4058,2500,1479,-1021,-227,17
1914,87,"4,5",Basel-Stadt,4058,2450,1479,-971,-216,17
1915,89,"2,5",Zürich,8355,1490,1753,263,105,"19,7"
1915,89,"2,5",Thurgau,8355,1490,1259,-231,-92,"14,15"
1916,96,"4,5",Waadt,1007,2820,1565,-1255,-279,"16,3"
1919,31,1,St. Gallen,7310,1050,493,-557,-557,"15,9"
1920,69,"2,5",Zürich,8714,1930,1359,-571,-228,"19,7"
1920,69,"2,5",St. Gallen,8714,1930,1028,-902,-361,"14,9"
1921,124,"4,5",St. Gallen,8737,2250,1618,-632,-140,"13,05"
1922,70,"2,5",St. Gallen,8737,1950,1043,-907,-363,"14,9"
1923,150,"2,5",Zürich,8633,4550,2955,-1595,-638,"19,7"
1923,150,"2,5",St. Gallen,8633,4550,2235,-2315,-926,"14,9"
1925,131,"4,5",St. Gallen,8737,2020,1710,-310,-69,"13,05"
1926,95,"4,5",St. Gallen,8645,2400,1240,-1160,-258,"13,05"
1927,155,"5,5",St. Gallen,8645,3250,1945,-1305,-237,"12,55"
1928,80,"3,5",St. Gallen,8737,2050,1108,-942,-269,"13,85"
1929,83,"4,5",St. Gallen,8645,2000,1083,-917,-204,"13,05"
1931,68,"3,5",St. Gallen,8645,1900,942,-958,-274,"13,85"
1932,72,"2,5",Zürich,8714,2080,1418,-662,-265,"19,7"
1932,72,"2,5",St. Gallen,8714,2080,1073,-1007,-403,"14,9"
1933,124,"4,5",St. Gallen,8737,2200,1618,-582,-129,"13,05"
1934,97,"4,5",Zürich,8820,1690,1702,12,3,"17,55"
1935,52,2,St. Gallen,8645,1295,801,-494,-247,"15,4"
1936,44,2,Genf,1208,1490,827,-663,-332,"18,8"
1937,88,"3,5",Genf,1201,2000,1610,-390,-111,"18,3"
1938,80,"3,5",Basel-Landschaft,4052,1650,1316,-334,-95,"16,45"
1938,80,"3,5",Basel-Stadt,4052,1650,1340,-310,-89,"16,75"
1939,56,"2,5",Zürich,8302,2010,1103,-907,-363,"19,7"
1942,68,3,Zürich,8005,1890,1272,-618,-206,"18,7"
1943,47,2,Zürich,8610,1550,973,-577,-289,"20,7"
1944,83,"3,5",Zürich,8707,2225,1502,-723,-207,"18,1"
1946,47,2,Neuchâtel,2000,1060,592,-468,-234,"12,6"
1947,107,"3,5",Aargau,4663,2190,1573,-617,-176,"14,7"
1947,107,"3,5",Solothurn,4663,2190,1418,-772,-221,"13,25"
1948,144,"3,5",Zürich,8451,1940,2606,666,190,"18,1"
1950,117,5,Zürich,8803,3550,2059,-1491,-298,"17,6"
1952,127,"4,5",Zürich,8152,2690,2229,-461,-102,"17,55"
1954,66,3,Basel-Stadt,4057,1115,1109,-6,-2,"16,8"
1956,80,"3,5",Schwyz,8832,2100,1292,-808,-231,"16,15"
1957,80,"3,5",St. Gallen,8636,1700,1108,-592,-169,"13,85"
1957,80,"3,5",Zürich,8636,1700,1448,-252,-72,"18,1"
1959,50,"2,5",Solothurn,4227,1160,688,-472,-189,"13,75"
1960,86,"3,5",Obwalden,6010,2330,1187,-1143,-327,"13,8"
1960,86,"3,5",Nidwalden,6010,2330,1367,-963,-275,"15,9"
1960,86,"3,5",Luzern,6010,2330,1273,-1057,-302,"14,8"
1961,52,2,St. Gallen,9630,940,801,-139,-70,"15,4"
1962,28,1,Luzern,6030,850,526,-324,-324,"18,8"
1963,120,"5,5",Basel-Landschaft,4416,1990,2112,122,22,"17,6"
1965,82,"3,5",St. Gallen,8880,1750,1136,-614,-175,"13,85"
1966,59,"2,5",Zürich,8127,1890,1162,-728,-291,"19,7"
1967,98,"3,5",Waadt,1814,2330,1617,-713,-204,"16,5"
1968,113,"5,5",Aargau,4313,1830,1599,-231,-42,"14,15"
1969,79,3,Basel-Stadt,4056,1495,1327,-168,-56,"16,8"
1970,74,"2,5",Luzern,6006,1705,1191,-514,-206,"16,1"
1971,69,"2,5",Zug,6300,2220,1421,-799,-320,"20,6"
1972,65,"2,5",Bern,3110,1520,965,-555,-222,"14,85"
1973,101,"4,5",Waadt,1012,2355,1646,-709,-158,"16,3"
1975,30,"1,5",Zürich,8004,1615,638,-977,-651,"21,25"
1976,60,3,Zürich,8610,1439,1122,-317,-106,"18,7"
1978,86,"3,5",Zürich,8953,2035,1557,-478,-137,"18,1"
1978,86,"3,5",Aargau,8953,2035,1264,-771,-220,"14,7"
1980,71,"4,5",Zürich,8810,1530,1246,-284,-63,"17,55"
1981,185,"4,5",Basel-Landschaft,4142,3650,3053,-597,-133,"16,5"
1982,100,"4,5",Bern,3098,1995,1385,-610,-136,"13,85"
1983,78,"4,5",St. Gallen,9200,1600,1018,-582,-129,"13,05"
1984,74,"3,5",Zürich,8907,1653,1339,-314,-90,"18,1"
1985,30,"2,5",Schaffhausen,8240,1270,431,-839,-336,"14,35"
1986,22,"3,5",Schaffhausen,8240,1660,289,-1371,-392,"13,15"
1989,11,"3,5",Schaffhausen,8240,1460,145,-1315,-376,"13,15"
1991,68,"3,5",Zürich,8123,1590,1231,-359,-103,"18,1"
1992,22,"4,5",Schaffhausen,8240,1900,287,-1613,-358,"13,05"
1994,58,"2,5",Glarus,8865,1220,809,-411,-164,"13,95"
1995,49,"2,5",Aargau,5734,1150,762,-388,-155,"15,55"
2001,56,"2,5",Thurgau,9500,980,792,-188,-75,"14,15"
2001,56,"2,5",St. Gallen,9500,980,834,-146,-58,"14,9"
2002,70,"3,5",Solothurn,4512,930,928,-2,-1,"13,25"
2006,65,"2,5",Zürich,8906,1378,1281,-97,-39,"19,7"
2007,170,"5,5",Thurgau,8280,2390,2015,-375,-68,"11,85"
2008,90,"4,5",Solothurn,4512,1150,1161,11,2,"12,9"
2009,30,1,Basel-Landschaft,4053,1270,510,-760,-760,17
2009,30,1,Basel-Stadt,4053,1270,525,-745,-745,"17,5"
2013,110,"5,5",Waadt,1018,2950,1870,-1080,-196,17
2020,112,"4,5",Zürich,8498,2200,1966,-234,-52,"17,55"
2022,158,"4,5",Aargau,4665,1950,2252,302,67,"14,25"
2024,72,3,Schaffhausen,8200,1325,972,-353,-118,"13,5"
2026,79,"3,5",Zürich,8952,1780,1430,-350,-100,"18,1"
2027,78,"4,5",Zürich,8424,1690,1369,-321,-71,"17,55"
2028,60,3,Zürich,8048,1850,1122,-728,-243,"18,7"
2029,29,1,Basel-Stadt,4056,865,508,-357,-357,"17,5"
2030,66,"2,5",Zürich,8307,1507,1300,-207,-83,"19,7"
2031,71,"3,5",Aargau,5316,1190,1044,-146,-42,"14,7"
2032,93,"3,5",Basel-Landschaft,4053,1930,1530,-400,-114,"16,45"
2032,93,"3,5",Basel-Stadt,4053,1930,1558,-372,-106,"16,75"
2033,92,4,Zürich,8908,1810,1610,-200,-50,"17,5"
2034,50,2,Basel-Landschaft,4123,1120,855,-265,-133,"17,1"
2035,45,1,Basel-Landschaft,4104,870,765,-105,-105,17
2037,58,3,Zürich,8055,1780,1085,-695,-232,"18,7"
2038,100,"4,5",Zürich,8134,1830,1755,-75,-17,"17,55"
2044,20,1,Zürich,8037,950,436,-514,-514,"21,8"
2050,25,1,Tessin,6592,675,293,-382,-382,"11,7"
2053,46,2,Zürich,8330,1600,952,-648,-324,"20,7"
2054,68,"3,5",Zürich,8330,2020,1231,-789,-225,"18,1"
2055,68,"3,5",Aargau,5737,1000,1000,0,0,"14,7"
2056,64,3,Aargau,4802,1160,966,-194,-65,"15,1"
2057,77,"3,5",Aargau,5406,1450,1132,-318,-91,"14,7"
2058,27,"1,5",Genf,1234,1250,520,-730,-487,"19,25"
2059,216,"4,5",Basel-Stadt,4051,3670,3672,2,0,17
2062,77,3,Basel-Stadt,4126,1560,1294,-266,-89,"16,8"
2065,82,4,Zürich,8700,2985,1435,-1550,-388,"17,5"
2066,100,"4,5",Zürich,8603,1720,1755,35,8,"17,55"
2067,85,"4,5",Zürich,8134,2160,1492,-668,-148,"17,55"
2068,94,"3,5",Aargau,5018,1830,1382,-448,-128,"14,7"
2071,240,6,Genf,1217,5600,5424,-176,-29,"22,6"
2072,60,4,Genf,1217,2025,1086,-939,-235,"18,1"
2075,128,"4,5",St. Gallen,9470,2520,1670,-850,-189,"13,05"
2076,80,"3,5",Neuchâtel,2017,1600,956,-644,-184,"11,95"
2078,70,"2,5",Zürich,8105,1610,1379,-231,-92,"19,7"
2079,116,"4,5",Schaffhausen,8222,1940,1514,-426,-95,"13,05"
2080,38,"1,5",Wallis,1868,996,614,-382,-255,"16,15"
2081,125,"4,5",St. Gallen,9470,2670,1631,-1039,-231,"13,05"
2082,40,1,Solothurn,4653,1140,516,-624,-624,"12,9"
2084,56,"2,5",Zürich,8048,1590,1103,-487,-195,"19,7"
2085,81,3,Basel-Landschaft,4052,1665,1353,-312,-104,"16,7"
2085,81,3,Basel-Stadt,4052,1665,1361,-304,-101,"16,8"
2087,85,3,St. Gallen,8636,1300,1224,-76,-25,"14,4"
2087,85,3,Zürich,8636,1300,1590,290,97,"18,7"
2088,141,"4,5",St. Gallen,9470,2780,1840,-940,-209,"13,05"
2089,98,"4,5",Aargau,5024,2175,1397,-778,-173,"14,25"
2090,82,"3,5",Aargau,5024,1935,1205,-730,-209,"14,7"
2092,75,3,Basel-Stadt,4058,1412,1260,-152,-51,"16,8"
2093,80,3,Bern,3097,1480,1160,-320,-107,"14,5"
2094,49,1,Basel-Landschaft,4437,685,833,148,148,17
2095,116,"4,5",Schwyz,8855,2930,1815,-1115,-248,"15,65"
2096,110,"3,5",Zürich,8483,1740,1991,251,72,"18,1"
2098,110,4,Aargau,5612,1820,1573,-247,-62,"14,3"
2099,100,"3,5",Aargau,5033,1900,1470,-430,-123,"14,7"
2100,180,"5,5",Aargau,5033,2200,2547,347,63,"14,15"
2101,48,"2,5",Wallis,1868,3142,691,-2451,-980,"14,4"
2102,150,"5,5",Obwalden,6010,4200,1883,-2317,-421,"12,55"
2102,150,"5,5",Nidwalden,6010,4200,2205,-1995,-363,"14,7"
2102,150,"5,5",Luzern,6010,4200,2123,-2077,-378,"14,15"
2103,116,"4,5",Schaffhausen,8222,1990,1514,-476,-106,"13,05"
2104,63,3,Zürich,8405,1490,1178,-312,-104,"18,7"
2105,86,"4,5",Zürich,8406,1580,1509,-71,-16,"17,55"
2107,65,"2,5",Solothurn,4600,1220,894,-326,-130,"13,75"
2107,65,"2,5",Aargau,4600,1220,1011,-209,-84,"15,55"
2108,130,"4,5",Bern,3783,3500,1801,-1699,-378,"13,85"
2109,70,3,Zürich,8413,1385,1309,-76,-25,"18,7"
2111,40,"1,5",Bern,2504,1110,624,-486,-324,"15,6"
2112,63,"2,5",Luzern,6003,1850,1014,-836,-334,"16,1"
2114,84,"2,5",Solothurn,4208,1245,1155,-90,-36,"13,75"
2115,90,3,Waadt,1814,1450,1539,89,30,"17,1"
2117,99,"3,5",Waadt,1041,2230,1634,-596,-170,"16,5"
2123,77,"2,5",Bern,3860,1060,1143,83,33,"14,85"
2124,95,"3,5",Thurgau,9320,1700,1268,-432,-123,"13,35"
2125,45,"2,5",St. Gallen,9230,950,671,-279,-112,"14,9"
2128,55,3,Waadt,1004,1425,941,-484,-161,"17,1"
2131,120,"5,5",Thurgau,8255,2090,1422,-668,-121,"11,85"
2134,48,"2,5",Wallis,1868,1248,691,-557,-223,"14,4"
2135,151,5,Zürich,8465,2000,2658,658,132,"17,6"
2136,78,"3,5",Waadt,1004,1950,1287,-663,-189,"16,5"
2138,115,"4,5",Luzern,6036,1760,1627,-133,-30,"14,15"
2140,36,"1,5",St. Gallen,7310,850,563,-287,-191,"15,65"
2141,108,"2,5",Thurgau,9545,1530,1528,-2,-1,"14,15"
2142,80,3,Thurgau,8570,1245,1112,-133,-44,"13,9"
2144,118,"4,5",Thurgau,9500,1830,1457,-373,-83,"12,35"
2144,118,"4,5",St. Gallen,9500,1830,1540,-290,-64,"13,05"
2145,140,"4,5",Thurgau,8595,2250,1729,-521,-116,"12,35"
2146,154,"4,5",St. Gallen,9327,2590,2010,-580,-129,"13,05"
2147,120,"4,5",Zürich,8112,2200,2106,-94,-21,"17,55"
2148,45,2,Zürich,8618,952,932,-20,-10,"20,7"
2149,54,2,Zürich,8057,1620,1118,-502,-251,"20,7"
2151,75,"3,5",Bern,2502,1395,1073,-322,-92,"14,3"
2152,65,"2,5",Schwyz,6438,1080,1108,28,11,"17,05"
2154,42,2,Graubünden,7206,1120,689,-431,-216,"16,4"
2155,150,"5,5",Appenzell Innerrhoden,9413,1600,2078,478,87,"13,85"
2155,150,"5,5",Appenzell Ausserrhoden,9413,1600,1695,95,17,"11,3"
2156,88,"3,5",St. Gallen,8887,1430,1219,-211,-60,"13,85"
2158,145,"3,5",St. Gallen,9451,1600,2008,408,117,"13,85"
2159,70,"3,5",St. Gallen,9451,1300,970,-330,-94,"13,85"
2160,76,"2,5",Aargau,5600,1620,1182,-438,-175,"15,55"
2164,68,"3,5",Basel-Landschaft,4153,1384,1119,-265,-76,"16,45"
2165,77,"2,5",Appenzell Innerrhoden,9050,1470,1009,-461,-184,"13,1"
2167,55,"2,5",Bern,3770,1250,817,-433,-173,"14,85"
2171,60,3,Aargau,5000,1200,906,-294,-98,"15,1"
2172,33,1,Obwalden,6010,805,525,-280,-280,"15,9"
2172,33,1,Nidwalden,6010,805,482,-323,-323,"14,6"
2172,33,1,Luzern,6010,805,620,-185,-185,"18,8"
2173,80,"3,5",Solothurn,2545,1390,1060,-330,-94,"13,25"
2174,140,"3,5",Graubünden,7000,2500,2107,-393,-112,"15,05"
2176,30,1,Bern,3013,1040,480,-560,-560,16
2177,60,3,Thurgau,8500,1300,834,-466,-155,"13,9"
2177,60,3,Zürich,8500,1300,1122,-178,-59,"18,7"
2178,90,"3,5",Aargau,5405,1577,1323,-254,-73,"14,7"
2179,86,"4,5",St. Gallen,7310,1650,1122,-528,-117,"13,05"
2181,80,"3,5",Basel-Stadt,4057,1621,1340,-281,-80,"16,75"
2182,120,"3,5",Zürich,8462,1590,2172,582,166,"18,1"
2183,101,4,Basel-Stadt,4058,1746,1687,-59,-15,"16,7"
2184,98,"4,5",St. Gallen,8896,1500,1279,-221,-49,"13,05"
2185,60,2,Basel-Landschaft,4457,1280,1026,-254,-127,"17,1"
2186,90,"3,5",Aargau,4800,1690,1323,-367,-105,"14,7"
2187,91,"4,5",Graubünden,7130,1550,1229,-321,-71,"13,5"
2189,58,"2,5",Basel-Stadt,4125,1326,1015,-311,-124,"17,5"
2190,76,"3,5",Zürich,8051,2135,1376,-759,-217,"18,1"
2192,114,"4,5",Aargau,5080,1980,1625,-355,-79,"14,25"
2195,85,"4,5",Basel-Stadt,4051,1900,1445,-455,-101,17
2196,76,"3,5",Zürich,8008,3675,1376,-2299,-657,"18,1"
2199,20,1,Bern,3007,820,320,-500,-500,16
2200,60,3,Bern,3011,994,870,-124,-41,"14,5"
2202,74,"2,5",St. Gallen,9437,1390,1103,-287,-115,"14,9"
2202,74,"2,5",Appenzell Ausserrhoden,9437,1390,1029,-361,-144,"13,9"
2204,85,"3,5",Solothurn,4563,1320,1126,-194,-55,"13,25"
2205,22,1,Waadt,1003,1140,469,-671,-671,"21,3"
2206,42,"2,5",Waadt,1004,1510,743,-767,-307,"17,7"
2207,60,2,Waadt,1820,1650,1098,-552,-276,"18,3"
2208,20,1,Wallis,3963,725,348,-377,-377,"17,4"
2209,97,"3,5",Aargau,4310,2085,1426,-659,-188,"14,7"
2210,80,3,Basel-Stadt,4054,1600,1344,-256,-85,"16,8"
2211,69,"2,5",Zürich,8308,1570,1359,-211,-84,"19,7"
2215,79,"4,5",Bern,3063,1660,1094,-566,-126,"13,85"
2216,85,"4,5",Zürich,8132,1745,1492,-253,-56,"17,55"
2217,105,"4,5",Zürich,8466,1820,1843,23,5,"17,55"
2219,60,3,Waadt,1028,1430,1026,-404,-135,"17,1"
2220,93,"3,5",Zürich,8038,2480,1683,-797,-228,"18,1"
2222,105,"4,5",Graubünden,7205,1948,1418,-530,-118,"13,5"
2223,95,"3,5",Neuchâtel,2400,895,1135,240,69,"11,95"
2224,60,3,Zürich,8004,2500,1122,-1378,-459,"18,7"
2225,47,"1,5",Solothurn,4612,890,630,-260,-173,"13,4"
2226,81,"2,5",Solothurn,4612,1310,1114,-196,-78,"13,75"
2228,37,1,Zürich,8001,3200,807,-2393,-2393,"21,8"
2229,108,"4,5",Aargau,5400,2320,1539,-781,-174,"14,25"
2230,29,1,Zürich,8001,2900,632,-2268,-2268,"21,8"
2231,36,"1,5",Wallis,1868,1118,581,-537,-358,"16,15"
2234,70,3,Tessin,6632,1450,945,-505,-168,"13,5"
2235,63,"3,5",Waadt,1018,1650,1040,-610,-174,"16,5"
2236,50,2,Zürich,8603,1585,1035,-550,-275,"20,7"
2238,108,"4,5",Thurgau,8280,2050,1334,-716,-159,"12,35"
2241,68,3,St. Gallen,8645,1610,979,-631,-210,"14,4"
2242,96,4,Aargau,5605,1480,1373,-107,-27,"14,3"
2243,124,"4,5",Neuchâtel,2400,1395,1544,149,33,"12,45"
2244,89,5,St. Gallen,9400,1630,1139,-491,-98,"12,8"
2245,127,"3,5",Luzern,6274,2230,1880,-350,-100,"14,8"
2246,57,"2,5",St. Gallen,9658,750,849,99,40,"14,9"
2247,64,"3,5",Luzern,6003,1850,947,-903,-258,"14,8"
2248,55,"2,5",Tessin,6900,1350,734,-616,-246,"13,35"
2249,159,"4,5",Aargau,5400,3115,2266,-849,-189,"14,25"
2250,111,"4,5",Thurgau,8536,2100,1371,-729,-162,"12,35"
2251,153,"4,5",Bern,2504,1875,2119,244,54,"13,85"
2252,61,3,Schaffhausen,8200,1035,824,-211,-70,"13,5"
2253,102,"4,5",Aargau,5600,1840,1454,-386,-86,"14,25"
2254,55,"2,5",Neuchâtel,2300,900,668,-232,-93,"12,15"
2256,144,"5,5",Zürich,8050,3282,2570,-712,-129,"17,85"
2257,57,"2,5",Zürich,8049,2520,1123,-1397,-559,"19,7"
2259,89,"4,5",Bern,3604,1725,1233,-492,-109,"13,85"
2260,113,4,Bern,2504,1670,1593,-77,-19,"14,1"
2261,65,"2,5",Zürich,8422,1570,1281,-289,-116,"19,7"
2262,110,"4,5",Thurgau,8590,1898,1359,-539,-120,"12,35"
2263,76,"3,5",Zürich,8623,1760,1376,-384,-110,"18,1"
2264,45,2,Bern,2502,879,684,-195,-98,"15,2"
2266,104,3,Bern,2504,1330,1508,178,59,"14,5"
2272,55,"3,5",Genf,1224,2950,1007,-1943,-555,"18,3"
2273,150,"5,5",Basel-Landschaft,4244,2300,2640,340,62,"17,6"
2274,50,"2,5",Waadt,1004,1430,885,-545,-218,"17,7"
2275,108,"4,5",Aargau,5712,2390,1539,-851,-189,"14,25"
2276,119,"4,5",Luzern,6208,2160,1684,-476,-106,"14,15"
2277,45,2,Aargau,5200,1047,720,-327,-164,16
2279,137,"3,5",Zürich,8004,4600,2480,-2120,-606,"18,1"
2280,48,"3,5",St. Gallen,9014,1190,665,-525,-150,"13,85"
2280,48,"3,5",Appenzell Ausserrhoden,9014,1190,612,-578,-165,"12,75"
2281,54,2,Aargau,8962,1695,864,-831,-416,16
2282,105,"3,5",Zürich,8810,2490,1901,-589,-168,"18,1"
2284,90,3,Tessin,6614,1260,1215,-45,-15,"13,5"
2285,70,"3,5",Luzern,6130,1310,1036,-274,-78,"14,8"
2286,168,"4,5",Zürich,8712,6500,2948,-3552,-789,"17,55"
2289,67,3,Zürich,8005,2672,1253,-1419,-473,"18,7"
2291,82,"3,5",Waadt,1543,1825,1353,-472,-135,"16,5"
2292,60,"2,5",Zürich,8037,1215,1182,-33,-13,"19,7"
2300,82,"3,5",St. Gallen,9242,1510,1136,-374,-107,"13,85"
2301,62,"4,5",Zürich,8700,4160,1088,-3072,-683,"17,55"
2304,21,1,Zürich,8032,994,458,-536,-536,"21,8"
2305,79,"3,5",Zürich,8630,1850,1430,-420,-120,"18,1"
2305,79,"3,5",St. Gallen,8630,1850,1094,-756,-216,"13,85"
2307,100,"3,5",Waadt,1170,2400,1650,-750,-214,"16,5"
2308,176,"5,5",Waadt,1170,3300,2992,-308,-56,17
2311,94,"3,5",Thurgau,8555,1800,1255,-545,-156,"13,35"
2312,111,"3,5",Bern,3011,2990,1587,-1403,-401,"14,3"
2314,89,"3,5",Zürich,8142,2810,1611,-1199,-343,"18,1"
2319,82,"3,5",Bern,2560,1373,1173,-200,-57,"14,3"
2322,80,3,Zürich,8050,2500,1496,-1004,-335,"18,7"
2324,49,2,Waadt,1110,1490,897,-593,-297,"18,3"
2325,122,"3,5",Schwyz,8640,3250,1970,-1280,-366,"16,15"
2325,122,"3,5",St. Gallen,8640,3250,1690,-1560,-446,"13,85"
2326,58,"2,5",Zürich,8001,3230,1143,-2087,-835,"19,7"
2327,77,"3,5",Aargau,5503,1810,1132,-678,-194,"14,7"
2328,180,6,St. Gallen,8645,2950,2214,-736,-123,"12,3"
2329,82,3,Zürich,8952,1700,1533,-167,-56,"18,7"
2330,111,"3,5",Luzern,6020,1925,1643,-282,-81,"14,8"
2331,74,"2,5",St. Gallen,9437,1390,1103,-287,-115,"14,9"
2331,74,"2,5",Appenzell Ausserrhoden,9437,1390,1029,-361,-144,"13,9"
2332,85,"3,5",St. Gallen,9403,1800,1177,-623,-178,"13,85"
2334,88,"3,5",Aargau,5036,1790,1294,-496,-142,"14,7"
2335,40,2,Zürich,8706,1599,828,-771,-386,"20,7"
2336,118,5,Zürich,8604,2098,2077,-21,-4,"17,6"
2337,100,"3,5",Waadt,1523,1680,1650,-30,-9,"16,5"
2338,80,4,Thurgau,8280,1450,1024,-426,-107,"12,8"
2339,56,3,Basel-Stadt,4056,1360,941,-419,-140,"16,8"
2343,159,"3,5",Zürich,8212,2140,2878,738,211,"18,1"
2343,159,"3,5",Schaffhausen,8212,2140,2091,-49,-14,"13,15"
2344,53,"2,5",Zürich,8045,2450,1044,-1406,-562,"19,7"
2345,87,"3,5",Aargau,5242,1687,1279,-408,-117,"14,7"
2346,84,"3,5",Zürich,8331,1850,1520,-330,-94,"18,1"
2348,105,"4,5",Zürich,8037,1950,1843,-107,-24,"17,55"
2351,35,1,Aargau,5300,940,571,-369,-369,"16,3"
2353,65,"2,5",Bern,3600,1740,965,-775,-310,"14,85"
2354,150,5,Zürich,8626,1980,2640,660,132,"17,6"
2355,97,"3,5",Zürich,8005,3210,1756,-1454,-415,"18,1"
2356,59,"2,5",Zürich,8404,1480,1162,-318,-127,"19,7"
2357,55,1,Aargau,8962,1380,897,-483,-483,"16,3"
2358,125,"4,5",St. Gallen,8737,1980,1631,-349,-78,"13,05"
2360,85,4,Waadt,1291,2385,1352,-1033,-258,"15,9"
2361,80,"2,5",Solothurn,4612,1490,1100,-390,-156,"13,75"
2362,94,"3,5",Basel-Landschaft,4460,1750,1546,-204,-58,"16,45"
2367,110,"3,5",Zürich,8330,4063,1991,-2072,-592,"18,1"
2370,126,"4,5",Zürich,8118,2950,2211,-739,-164,"17,55"
2371,84,"4,5",Aargau,5620,1490,1197,-293,-65,"14,25"
2372,86,4,Aargau,5442,1483,1230,-253,-63,"14,3"
2375,108,"4,5",Wallis,1870,1765,1372,-393,-87,"12,7"
2376,300,"4,5",Aargau,5304,2490,4275,1785,397,"14,25"
2377,80,"4,5",Zürich,8048,2060,1404,-656,-146,"17,55"
2378,70,"2,5",Basel-Landschaft,4450,1450,1183,-267,-107,"16,9"
2379,105,"4,5",Zürich,8608,1970,1843,-127,-28,"17,55"
2380,143,"4,5",Zürich,8112,3005,2510,-495,-110,"17,55"
2381,62,3,Zürich,8406,1501,1159,-342,-114,"18,7"
2382,120,"4,5",Zürich,8400,2945,2106,-839,-186,"17,55"
2383,153,"5,5",Luzern,6231,2300,2165,-135,-25,"14,15"
2384,77,"2,5",Bern,3011,2600,1143,-1457,-583,"14,85"
2385,35,"1,5",Aargau,5400,1150,565,-585,-390,"16,15"
2386,62,"2,5",Zug,6300,2860,1277,-1583,-633,"20,6"
2388,64,"4,5",St. Gallen,9016,1350,835,-515,-114,"13,05"
2389,124,"4,5",Zürich,8405,2666,2176,-490,-109,"17,55"
2391,80,4,Genf,1233,2440,1448,-992,-248,"18,1"
2392,77,"3,5",Thurgau,9320,1040,1028,-12,-3,"13,35"
2393,91,"3,5",Zürich,8620,2250,1647,-603,-172,"18,1"
2394,220,"5,5",Basel-Landschaft,4419,2400,3872,1472,268,"17,6"
2395,128,"4,5",Thurgau,8360,2000,1581,-419,-93,"12,35"
2396,114,"3,5",Zürich,8158,3280,2063,-1217,-348,"18,1"
2397,60,"2,5",Schwyz,8853,1590,1023,-567,-227,"17,05"
2399,70,"2,5",Zürich,8193,1650,1379,-271,-108,"19,7"
2400,74,"3,5",Zürich,8050,2050,1339,-711,-203,"18,1"
2402,105,"4,5",St. Gallen,8645,2050,1370,-680,-151,"13,05"
2403,70,"2,5",Zürich,8610,1785,1379,-406,-162,"19,7"
2404,87,"3,5",Aargau,5453,1590,1279,-311,-89,"14,7"
2405,80,3,Basel-Stadt,4056,1750,1344,-406,-135,"16,8"
2406,70,2,Aargau,5430,1270,1120,-150,-75,16
2409,76,"3,5",Zürich,8008,3675,1376,-2299,-657,"18,1"
2411,73,"3,5",Zürich,8633,1830,1321,-509,-145,"18,1"
2411,73,"3,5",St. Gallen,8633,1830,1011,-819,-234,"13,85"
2413,105,"4,5",Zürich,8307,1920,1843,-77,-17,"17,55"
2415,150,"4,5",Zürich,8212,2370,2633,263,58,"17,55"
2415,150,"4,5",Schaffhausen,8212,2370,1958,-412,-92,"13,05"
2416,80,3,Bern,3800,1400,1160,-240,-80,"14,5"
2418,134,"4,5",Bern,3627,2200,1856,-344,-76,"13,85"
2419,90,"3,5",Bern,3612,1350,1287,-63,-18,"14,3"
2420,72,"3,5",Bern,3510,1500,1030,-470,-134,"14,3"
2421,70,"3,5",Bern,3860,1500,1001,-499,-143,"14,3"
2422,91,"3,5",St. Gallen,9451,1500,1260,-240,-69,"13,85"
2425,86,2,Bern,3507,950,1307,357,179,"15,2"
2426,25,1,Bern,3818,650,400,-250,-250,16
2427,66,3,Solothurn,4600,1500,898,-602,-201,"13,6"
2427,66,3,Aargau,4600,1500,997,-503,-168,"15,1"
2428,50,"2,5",Bern,3027,1100,743,-357,-143,"14,85"
2429,90,"4,5",Bern,3123,1700,1247,-453,-101,"13,85"
2430,70,3,Bern,3006,1550,1015,-535,-178,"14,5"
2431,27,1,Bern,3005,769,432,-337,-337,16
2436,60,"2,5",Bern,3097,1200,891,-309,-124,"14,85"
2437,70,"5,5",St. Gallen,9658,1030,879,-151,-27,"12,55"
2439,60,3,Bern,2504,1060,870,-190,-63,"14,5"
2440,58,2,St. Gallen,9014,920,893,-27,-14,"15,4"
2440,58,2,Appenzell Ausserrhoden,9014,920,870,-50,-25,15
2442,63,3,Bern,3250,1350,914,-436,-145,"14,5"
2445,83,4,Luzern,6020,1380,1179,-201,-50,"14,2"
2446,80,"3,5",Zürich,8049,1952,1448,-504,-144,"18,1"
2447,113,"4,5",Luzern,6004,3190,1599,-1591,-354,"14,15"
2449,114,"3,5",Graubünden,7000,2590,1716,-874,-250,"15,05"
2452,60,"2,5",Luzern,6048,1400,966,-434,-174,"16,1"
2455,65,3,Zürich,8055,2300,1216,-1084,-361,"18,7"
2456,94,"4,5",Luzern,6006,2740,1330,-1410,-313,"14,15"
2457,65,"3,5",Schaffhausen,8239,1225,855,-370,-106,"13,15"
2460,36,1,Zürich,8408,812,785,-27,-27,"21,8"
2461,58,"2,5",Graubünden,7270,1500,919,-581,-232,"15,85"
2462,45,"2,5",Bern,3818,900,668,-232,-93,"14,85"
2464,57,3,Aargau,5032,1155,861,-294,-98,"15,1"
2466,111,"3,5",Graubünden,7000,2300,1671,-629,-180,"15,05"
2467,72,"3,5",Zürich,8008,2795,1303,-1492,-426,"18,1"
2468,39,"1,5",St. Gallen,9630,770,610,-160,-107,"15,65"
2469,33,1,Basel-Stadt,4057,1320,578,-742,-742,"17,5"
2470,67,1,Basel-Stadt,4057,1850,1173,-677,-677,"17,5"
2471,65,3,Basel-Stadt,4057,1850,1092,-758,-253,"16,8"
2472,63,"2,5",Basel-Stadt,4057,1850,1103,-747,-299,"17,5"
2474,25,1,Nidwalden,6386,850,365,-485,-485,"14,6"
2479,36,1,Zürich,8404,812,785,-27,-27,"21,8"
2481,55,"2,5",Zürich,8037,2200,1084,-1116,-446,"19,7"
2482,80,3,Zürich,8152,1798,1496,-302,-101,"18,7"
2490,45,1,Waadt,1530,770,959,189,189,"21,3"
2491,115,"4,5",Zürich,8625,2650,2018,-632,-140,"17,55"
2492,50,2,Basel-Stadt,4058,1980,910,-1070,-535,"18,2"
2493,130,"4,5",Zürich,8703,4831,2282,-2549,-566,"17,55"
2494,87,"3,5",Zürich,8304,2370,1575,-795,-227,"18,1"
2495,65,"3,5",Waadt,1008,2100,1073,-1027,-293,"16,5"
2497,91,"4,5",Zürich,8032,2773,1597,-1176,-261,"17,55"
2499,60,"2,5",Luzern,6014,1450,966,-484,-194,"16,1"
2502,21,1,Waadt,1023,1064,447,-617,-617,"21,3"
2503,55,2,Zürich,8008,1680,1139,-541,-271,"20,7"
2514,110,"4,5",Zürich,8620,2140,1931,-209,-46,"17,55"
2517,19,1,Zürich,8708,600,414,-186,-186,"21,8"
2522,70,"3,5",St. Gallen,9430,1100,970,-130,-37,"13,85"
2523,55,"2,5",Waadt,1005,1420,974,-446,-178,"17,7"
2526,90,"4,5",Basel-Stadt,4051,1900,1530,-370,-82,17
2527,82,"3,5",St. Gallen,9008,1820,1136,-684,-195,"13,85"
2528,85,4,St. Gallen,9607,920,1131,211,53,"13,3"
2530,30,1,Zürich,8600,890,654,-236,-236,"21,8"
2552,80,3,Bern,3626,1400,1160,-240,-80,"14,5"
2554,63,"2,5",Zürich,8483,1430,1241,-189,-76,"19,7"
2555,45,3,St. Gallen,9014,1190,648,-542,-181,"14,4"
2555,45,3,Appenzell Ausserrhoden,9014,1190,576,-614,-205,"12,8"
2558,70,"3,5",Zürich,8047,2440,1267,-1173,-335,"18,1"
2560,74,"3,5",Luzern,6207,1350,1095,-255,-73,"14,8"
2561,90,"3,5",Aargau,5405,1577,1323,-254,-73,"14,7"
2562,132,"4,5",St. Gallen,9032,2340,1723,-617,-137,"13,05"
2563,35,1,Basel-Stadt,4055,940,613,-327,-327,"17,5"
2565,65,"3,5",Zürich,8050,2395,1177,-1218,-348,"18,1"
2573,52,"2,5",Waadt,1815,1395,920,-475,-190,"17,7"
2576,79,"3,5",Zürich,8340,1690,1430,-260,-74,"18,1"
2577,124,"4,5",Zürich,8157,2040,2176,136,30,"17,55"
2578,107,"5,5",Zürich,8162,2050,1910,-140,-25,"17,85"
2579,58,3,Schwyz,8640,1570,945,-625,-208,"16,3"
2579,58,3,St. Gallen,8640,1570,835,-735,-245,"14,4"
2580,89,"3,5",Zürich,8157,1670,1611,-59,-17,"18,1"
2581,106,"4,5",Zürich,8162,2125,1860,-265,-59,"17,55"
2582,73,"3,5",Glarus,8752,1230,927,-303,-87,"12,7"
2583,63,3,Zürich,8302,1780,1178,-602,-201,"18,7"
2584,50,2,Zürich,8302,1480,1035,-445,-223,"20,7"
2585,72,"3,5",Zürich,8162,1630,1303,-327,-93,"18,1"
2586,117,"5,5",Zürich,8157,2020,2088,68,12,"17,85"
2587,110,"4,5",Zürich,8952,2520,1931,-589,-131,"17,55"
2588,119,"5,5",Zürich,8910,2580,2124,-456,-83,"17,85"
2589,88,4,Thurgau,8280,1890,1126,-764,-191,"12,8"
2590,56,"2,5",St. Gallen,9451,1260,834,-426,-170,"14,9"
2591,92,"3,5",Aargau,5040,1270,1352,82,23,"14,7"
2592,120,"4,5",Aargau,5033,2390,1710,-680,-151,"14,25"
2593,90,"4,5",Basel-Landschaft,4242,1550,1485,-65,-14,"16,5"
2594,118,"4,5",Schwyz,6430,1995,1847,-148,-33,"15,65"
2595,57,"2,5",St. Gallen,9434,1170,849,-321,-128,"14,9"
2596,120,"3,5",St. Gallen,9444,1770,1662,-108,-31,"13,85"
2597,70,3,Glarus,8754,1150,889,-261,-87,"12,7"
2598,60,"3,5",Zug,6314,1980,1149,-831,-237,"19,15"
2599,82,"3,5",Graubünden,7418,1462,1234,-228,-65,"15,05"
2600,85,"3,5",Zürich,8174,1600,1539,-61,-17,"18,1"
2601,123,"4,5",Thurgau,8264,1960,1519,-441,-98,"12,35"
2604,89,"3,5",Aargau,4805,2130,1308,-822,-235,"14,7"
2605,87,"3,5",Glarus,8762,1400,1105,-295,-84,"12,7"
2606,67,"3,5",Aargau,8964,1480,985,-495,-141,"14,7"
2609,89,4,Zürich,8134,1790,1558,-232,-58,"17,5"
2611,51,"2,5",Zürich,8051,1800,1005,-795,-318,"19,7"
2612,51,"2,5",Zürich,8051,1800,1005,-795,-318,"19,7"
2613,134,"4,5",Luzern,6003,3840,1896,-1944,-432,"14,15"
2614,71,"2,5",Luzern,6003,2180,1143,-1037,-415,"16,1"
2616,115,"4,5",Thurgau,8500,1990,1420,-570,-127,"12,35"
2616,115,"4,5",Zürich,8500,1990,2018,28,6,"17,55"
2617,35,2,Nidwalden,6390,1050,581,-469,-235,"16,6"
2617,35,2,Obwalden,6390,1050,511,-539,-270,"14,6"
2617,35,2,Uri,6390,1050,469,-581,-291,"13,4"
2618,83,"3,5",Basel-Landschaft,4107,2490,1365,-1125,-321,"16,45"
2619,110,"4,5",Wallis,3920,2650,1397,-1253,-278,"12,7"
2620,62,"2,5",Zürich,8152,1695,1221,-474,-190,"19,7"
2622,93,"3,5",Thurgau,8505,1850,1242,-608,-174,"13,35"
2623,129,"4,5",Thurgau,8267,1810,1593,-217,-48,"12,35"
2624,120,"4,5",St. Gallen,9404,1750,1566,-184,-41,"13,05"
2625,48,2,Thurgau,8547,990,691,-299,-150,"14,4"
2628,75,"3,5",Thurgau,8280,1380,1001,-379,-108,"13,35"
2629,121,"4,5",Luzern,6004,3940,1712,-2228,-495,"14,15"
2630,122,"5,5",St. Gallen,9245,1810,1531,-279,-51,"12,55"
2631,80,"3,5",Thurgau,8370,1170,1068,-102,-29,"13,35"
2633,70,"3,5",Luzern,6203,1325,1036,-289,-83,"14,8"
2634,106,"4,5",Luzern,6206,2400,1500,-900,-200,"14,15"
2635,82,"2,5",Appenzell Innerrhoden,9450,1380,1074,-306,-122,"13,1"
2635,82,"2,5",Appenzell Ausserrhoden,9450,1380,1140,-240,-96,"13,9"
2635,82,"2,5",St. Gallen,9450,1380,1222,-158,-63,"14,9"
2637,55,2,Uri,6460,980,737,-243,-122,"13,4"
2639,115,"4,5",Zürich,8625,2650,2018,-632,-140,"17,55"
2641,55,"2,5",Schwyz,6423,1000,938,-62,-25,"17,05"
2643,174,"4,5",Basel-Landschaft,4410,2500,2871,371,82,"16,5"
2645,12,1,Obwalden,6010,630,191,-439,-439,"15,9"
2645,12,1,Nidwalden,6010,630,175,-455,-455,"14,6"
2645,12,1,Luzern,6010,630,226,-404,-404,"18,8"
2646,103,"3,5",Luzern,6274,1680,1524,-156,-45,"14,8"
2647,64,"2,5",Luzern,6353,1950,1030,-920,-368,"16,1"
2649,88,"3,5",Luzern,6353,2250,1302,-948,-271,"14,8"
2651,151,"5,5",Basel-Landschaft,4105,3800,2658,-1142,-208,"17,6"
2657,71,"3,5",Basel-Landschaft,4102,1560,1168,-392,-112,"16,45"
2658,81,3,Graubünden,7402,1490,1239,-251,-84,"15,3"
2659,154,"5,5",Aargau,5430,2630,2179,-451,-82,"14,15"
2660,95,"3,5",Basel-Landschaft,4242,1848,1563,-285,-81,"16,45"
2661,65,"2,5",Thurgau,9536,1340,920,-420,-168,"14,15"
2661,65,"2,5",St. Gallen,9536,1340,969,-371,-148,"14,9"
2663,107,"4,5",Luzern,6252,1810,1514,-296,-66,"14,15"
2665,44,2,Luzern,6030,1250,739,-511,-256,"16,8"
2667,50,2,Basel-Stadt,4125,1250,910,-340,-170,"18,2"
2668,83,"3,5",Basel-Landschaft,4242,2200,1365,-835,-239,"16,45"
2669,55,3,Thurgau,8280,1390,765,-625,-208,"13,9"
2671,115,"4,5",Thurgau,9320,1820,1420,-400,-89,"12,35"
2674,78,"3,5",Luzern,6243,1480,1154,-326,-93,"14,8"
2675,73,"2,5",Basel-Landschaft,4410,1370,1234,-136,-54,"16,9"
2676,110,"4,5",St. Gallen,9105,1395,1436,41,9,"13,05"
2676,110,"4,5",Appenzell Ausserrhoden,9105,1395,1348,-47,-10,"12,25"
2678,50,2,Basel-Stadt,4055,1300,910,-390,-195,"18,2"
2680,76,"2,5",St. Gallen,8737,1400,1132,-268,-107,"14,9"
2681,76,"2,5",St. Gallen,8737,1400,1132,-268,-107,"14,9"
2685,106,"4,5",Bern,3011,2600,1468,-1132,-252,"13,85"
2686,73,"2,5",Bern,3011,1940,1084,-856,-342,"14,85"
2689,35,1,Bern,3011,960,560,-400,-400,16
2695,50,2,Appenzell Innerrhoden,9056,800,560,-240,-120,"11,2"
2695,50,2,Appenzell Ausserrhoden,9056,800,750,-50,-25,15
2697,110,"4,5",St. Gallen,9000,1690,1436,-254,-56,"13,05"
2698,65,"2,5",Thurgau,9542,1450,920,-530,-212,"14,15"
2699,100,"4,5",Zug,6340,2500,1875,-625,-139,"18,75"
2700,42,"2,5",Luzern,6130,990,676,-314,-126,"16,1"
2701,106,"3,5",St. Gallen,9403,1850,1468,-382,-109,"13,85"
2705,75,4,Genf,1212,1980,1358,-622,-156,"18,1"
2707,104,"4,5",Bern,3600,1940,1440,-500,-111,"13,85"
2708,97,"4,5",Graubünden,7503,1690,1310,-380,-84,"13,5"
2710,79,"3,5",St. Gallen,9435,1655,1094,-561,-160,"13,85"
2711,211,"5,5",Thurgau,8272,3000,2500,-500,-91,"11,85"
2712,60,"2,5",St. Gallen,9477,1040,894,-146,-58,"14,9"
2713,30,1,Basel-Landschaft,4153,800,510,-290,-290,17
2714,30,1,Basel-Landschaft,4153,800,510,-290,-290,17
2717,88,"3,5",Graubünden,7430,1530,1324,-206,-59,"15,05"
2718,200,5,Tessin,6900,3900,2840,-1060,-212,"14,2"
2720,102,"3,5",St. Gallen,9434,1730,1413,-317,-91,"13,85"
2721,98,"3,5",St. Gallen,9435,1800,1357,-443,-127,"13,85"
2722,87,"3,5",Thurgau,9320,1280,1161,-119,-34,"13,35"
2725,40,"1,5",Basel-Stadt,4055,2175,714,-1461,-974,"17,85"
2726,16,1,St. Gallen,9000,570,254,-316,-316,"15,9"
2727,87,"3,5",Basel-Stadt,4056,2690,1457,-1233,-352,"16,75"
2728,86,"3,5",St. Gallen,9422,1620,1191,-429,-123,"13,85"
2729,73,4,St. Gallen,8887,970,971,1,0,"13,3"
2730,62,"2,5",St. Gallen,9435,1480,924,-556,-222,"14,9"
2734,173,"5,5",Basel-Stadt,4125,2650,3149,499,91,"18,2"
2735,57,"2,5",St. Gallen,9230,1180,849,-331,-132,"14,9"
2737,110,"4,5",St. Gallen,9477,1560,1436,-124,-28,"13,05"
2738,115,"3,5",Bern,3428,1790,1645,-145,-41,"14,3"
2739,65,"3,5",Solothurn,5014,1400,861,-539,-154,"13,25"
2740,104,"4,5",Aargau,5076,1740,1482,-258,-57,"14,25"
2741,160,"3,5",Zürich,8344,2800,2896,96,27,"18,1"
2742,127,4,Zug,6345,3200,2388,-812,-203,"18,8"
2744,114,"4,5",Basel-Landschaft,4246,1990,1881,-109,-24,"16,5"
2745,75,"3,5",Graubünden,7050,2050,1129,-921,-263,"15,05"
2746,194,"5,5",Bern,3283,2450,2629,179,33,"13,55"
2747,108,"3,5",Schwyz,8854,2430,1744,-686,-196,"16,15"
2748,84,"3,5",Basel-Landschaft,4133,1650,1382,-268,-77,"16,45"
2749,110,"3,5",Tessin,6579,1580,1485,-95,-27,"13,5"
2750,78,"2,5",Schwyz,8854,1955,1330,-625,-250,"17,05"
2751,60,"3,5",Freiburg,1774,1650,849,-801,-229,"14,15"
2752,145,"4,5",Obwalden,6062,2800,1914,-886,-197,"13,2"
2753,107,"4,5",Basel-Landschaft,4246,1850,1766,-84,-19,"16,5"
2754,127,"4,5",Schwyz,8832,3100,1988,-1112,-247,"15,65"
2755,90,"2,5",Basel-Landschaft,4127,1480,1521,41,16,"16,9"
2757,95,"3,5",Bern,3112,1980,1359,-621,-177,"14,3"
2761,114,"3,5",Luzern,6294,1550,1687,137,39,"14,8"
2762,75,3,Waadt,1054,1750,1283,-467,-156,"17,1"
2763,115,"4,5",Basel-Landschaft,4246,2410,1898,-512,-114,"16,5"
2764,99,"3,5",St. Gallen,7320,1820,1371,-449,-128,"13,85"
2765,110,"3,5",Tessin,6579,1480,1485,5,1,"13,5"
2766,113,"4,5",St. Gallen,9444,1970,1475,-495,-110,"13,05"
2767,122,"3,5",Schwyz,8730,2150,1970,-180,-51,"16,15"
2767,122,"3,5",St. Gallen,8730,2150,1690,-460,-131,"13,85"
2768,160,"5,5",Zug,6330,4200,3296,-904,-164,"20,6"
2769,91,"3,5",Aargau,5452,1850,1338,-512,-146,"14,7"
2770,100,"3,5",St. Gallen,9033,2000,1385,-615,-176,"13,85"
2771,101,"3,5",Schwyz,8854,2330,1631,-699,-200,"16,15"
2772,103,"4,5",Waadt,1304,2700,1679,-1021,-227,"16,3"
2775,117,"4,5",Luzern,6045,2590,1656,-934,-208,"14,15"
2776,140,"5,5",Zug,6332,2980,2884,-96,-17,"20,6"
2779,150,4,Zürich,8044,5100,2625,-2475,-619,"17,5"
2786,74,"2,5",Aargau,5600,1580,1151,-429,-172,"15,55"
2787,107,"4,5",Aargau,5525,1950,1525,-425,-94,"14,25"
2788,69,"3,5",Aargau,5035,1295,1014,-281,-80,"14,7"
2789,63,"3,5",Aargau,5417,1195,926,-269,-77,"14,7"
2790,67,4,Aargau,5610,1020,958,-62,-16,"14,3"
2791,77,"3,5",Waadt,1006,3585,1271,-2314,-661,"16,5"
2793,53,2,St. Gallen,9000,1290,816,-474,-237,"15,4"
2794,90,"4,5",Zürich,8422,1720,1580,-140,-31,"17,55"
2796,57,3,Basel-Landschaft,4402,1220,952,-268,-89,"16,7"
2797,77,"2,5",St. Gallen,9016,1570,1147,-423,-169,"14,9"
2798,59,3,Luzern,6003,1380,909,-471,-157,"15,4"
2799,71,"2,5",Luzern,6204,1450,1143,-307,-123,"16,1"
2800,72,"3,5",Basel-Landschaft,4410,1380,1184,-196,-56,"16,45"
2804,115,"4,5",Zürich,8107,2339,2018,-321,-71,"17,55"
2805,37,1,Basel-Stadt,4051,950,648,-302,-302,"17,5"
2806,64,"1,5",Zürich,8107,1382,1360,-22,-15,"21,25"
2807,124,"3,5",Waadt,1009,4536,2046,-2490,-711,"16,5"
2808,108,"4,5",Freiburg,1673,1501,1458,-43,-10,"13,5"
2809,142,4,Waadt,1008,4110,2258,-1852,-463,"15,9"
2810,78,"3,5",Wallis,1950,1550,1034,-516,-147,"13,25"
2811,149,"5,5",Schwyz,8832,4490,2421,-2069,-376,"16,25"
2813,104,"4,5",Waadt,1424,2100,1695,-405,-90,"16,3"
2815,52,"2,5",Waadt,1426,1330,920,-410,-164,"17,7"
2817,52,2,Waadt,1522,1200,952,-248,-124,"18,3"
2818,114,"4,5",Aargau,5080,1980,1625,-355,-79,"14,25"
2821,100,"3,5",Aargau,4316,1660,1470,-190,-54,"14,7"
2823,102,2,Waadt,1003,2430,1867,-563,-282,"18,3"
2824,36,1,Zürich,8046,1220,785,-435,-435,"21,8"
2825,91,"3,5",St. Gallen,8636,1780,1260,-520,-149,"13,85"
2825,91,"3,5",Zürich,8636,1780,1647,-133,-38,"18,1"
2829,145,"5,5",Zürich,8355,2495,2588,93,17,"17,85"
2829,145,"5,5",Thurgau,8355,2495,1718,-777,-141,"11,85"
2831,91,"4,5",Genf,1217,2700,1665,-1035,-230,"18,3"
2832,63,3,Genf,1208,3250,1166,-2084,-695,"18,5"
2834,120,"5,5",Genf,1213,3590,2466,-1124,-204,"20,55"
2835,190,6,Genf,1228,6000,4294,-1706,-284,"22,6"
2837,79,4,Genf,1213,2500,1430,-1070,-268,"18,1"
2840,314,5,Genf,1205,9500,5809,-3691,-738,"18,5"
2841,125,6,Genf,1285,2800,2825,25,4,"22,6"
2843,128,"4,5",Genf,1202,3700,2342,-1358,-302,"18,3"
2844,67,1,Basel-Stadt,4057,1850,1173,-677,-677,"17,5"
2845,63,"2,5",Basel-Stadt,4057,1850,1103,-747,-299,"17,5"
2846,65,3,Basel-Stadt,4057,1850,1092,-758,-253,"16,8"
2847,33,1,Basel-Stadt,4057,1320,578,-742,-742,"17,5"
2848,61,3,Graubünden,7000,1480,933,-547,-182,"15,3"
2850,155,"4,5",Zürich,8833,2500,2720,220,49,"17,55"
2850,155,"4,5",Schwyz,8833,2500,2426,-74,-16,"15,65"
2851,80,4,Genf,1233,2440,1448,-992,-248,"18,1"
2853,113,"4,5",Luzern,6004,3190,1599,-1591,-354,"14,15"
2854,60,"2,5",Waadt,1020,1500,1062,-438,-175,"17,7"
2855,71,"3,5",Waadt,1400,1600,1172,-428,-122,"16,5"
2856,56,"2,5",Waadt,1020,1552,991,-561,-224,"17,7"
2859,62,"2,5",Wallis,1950,1369,893,-476,-190,"14,4"
2860,102,"4,5",Solothurn,4658,1940,1316,-624,-139,"12,9"
2861,105,"4,5",Solothurn,4658,1940,1355,-585,-130,"12,9"
2862,58,"2,5",Solothurn,4658,1440,798,-642,-257,"13,75"
2863,56,"2,5",Aargau,5443,1240,871,-369,-148,"15,55"
2864,93,"4,5",Bern,3047,1805,1288,-517,-115,"13,85"
2866,76,"3,5",Zürich,8610,1712,1376,-336,-96,"18,1"
2867,84,"3,5",Zürich,8620,1850,1520,-330,-94,"18,1"
2868,104,"4,5",Zürich,8303,1990,1825,-165,-37,"17,55"
2870,46,1,Bern,3006,850,736,-114,-114,16
2871,40,"1,5",Schwyz,6440,1150,714,-436,-291,"17,85"
2873,83,"3,5",Freiburg,1700,1580,1174,-406,-116,"14,15"
2874,68,"3,5",Freiburg,1700,1375,962,-413,-118,"14,15"
2875,71,"3,5",Freiburg,1700,1440,1005,-435,-124,"14,15"
2876,72,"2,5",Freiburg,1700,1435,1098,-337,-135,"15,25"
2877,74,3,Waadt,1196,1655,1265,-390,-130,"17,1"
2878,59,2,Basel-Landschaft,4053,1580,1009,-571,-286,"17,1"
2878,59,2,Basel-Stadt,4053,1580,1074,-506,-253,"18,2"
2879,35,1,Zürich,8135,790,763,-27,-27,"21,8"
2884,31,1,Freiburg,1700,860,564,-296,-296,"18,2"
2888,57,"2,5",Luzern,6003,1830,918,-912,-365,"16,1"
2891,55,2,Basel-Stadt,4056,1230,1001,-229,-115,"18,2"
2892,85,"4,5",Luzern,6006,2740,1203,-1537,-342,"14,15"
2893,73,4,Genf,1208,2720,1321,-1399,-350,"18,1"
2894,128,"4,5",Waadt,1170,2900,2086,-814,-181,"16,3"
2895,106,"3,5",Waadt,1170,2255,1749,-506,-145,"16,5"
2896,68,"1,5",Thurgau,8500,1390,959,-431,-287,"14,1"
2896,68,"1,5",Zürich,8500,1390,1445,55,37,"21,25"
2899,83,3,Waadt,1114,1570,1419,-151,-50,"17,1"
2901,25,1,Zürich,8406,915,545,-370,-370,"21,8"
2904,70,"3,5",Tessin,6900,1400,945,-455,-130,"13,5"
2905,84,"3,5",Tessin,6834,1163,1134,-29,-8,"13,5"
2906,115,"4,5",Tessin,6834,1419,1593,174,39,"13,85"
2907,84,"3,5",Tessin,6834,1163,1134,-29,-8,"13,5"
2908,87,"3,5",Tessin,6834,870,1175,305,87,"13,5"
2909,91,"3,5",Tessin,6830,1250,1229,-21,-6,"13,5"
2911,90,"3,5",Tessin,6900,1500,1215,-285,-81,"13,5"
2912,103,"3,5",Tessin,6900,1520,1391,-129,-37,"13,5"
2916,90,"3,5",Tessin,6932,1550,1215,-335,-96,"13,5"
2917,59,"2,5",Tessin,6830,940,788,-152,-61,"13,35"
2919,107,"4,5",Aargau,4663,1950,1525,-425,-94,"14,25"
2919,107,"4,5",Solothurn,4663,1950,1380,-570,-127,"12,9"
2920,82,"4,5",Waadt,1854,2290,1337,-953,-212,"16,3"
2921,121,"4,5",Freiburg,1652,2035,1634,-401,-89,"13,5"
2922,121,"4,5",Freiburg,1652,2035,1634,-401,-89,"13,5"
2923,116,"4,5",Freiburg,1652,1930,1566,-364,-81,"13,5"
2924,70,"3,5",Bern,2560,1460,1001,-459,-131,"14,3"
2925,62,"3,5",Bern,3014,1750,887,-863,-247,"14,3"
2926,89,"2,5",Aargau,5415,1680,1384,-296,-118,"15,55"
2928,90,"4,5",Tessin,6512,1510,1247,-263,-58,"13,85"
2930,75,"3,5",Genf,1201,2680,1373,-1307,-373,"18,3"
2931,43,"2,5",Genf,1201,1540,802,-738,-295,"18,65"
2932,30,1,Genf,1204,1510,591,-919,-919,"19,7"
2936,102,"4,5",Wallis,1868,1880,1295,-585,-130,"12,7"
2937,55,"2,5",Wallis,1920,1340,792,-548,-219,"14,4"
2938,173,"5,5",Zürich,8134,3860,3088,-772,-140,"17,85"
2939,73,"3,5",Luzern,6020,1400,1080,-320,-91,"14,8"
2940,89,3,Waadt,1005,2420,1522,-898,-299,"17,1"
2941,88,3,Waadt,1005,2410,1505,-905,-302,"17,1"
2942,95,4,Waadt,1008,2240,1511,-729,-182,"15,9"
2943,75,"3,5",Basel-Landschaft,4242,1630,1234,-396,-113,"16,45"
2945,83,"3,5",Zürich,8245,1390,1502,112,32,"18,1"
2946,46,2,Zürich,8405,1240,952,-288,-144,"20,7"
2949,67,3,Freiburg,1700,1510,992,-518,-173,"14,8"
2950,53,"1,5",Bern,3600,1270,827,-443,-295,"15,6"
2951,107,"4,5",Zürich,8106,1670,1878,208,46,"17,55"
2952,88,"3,5",Solothurn,4542,1290,1166,-124,-35,"13,25"
2953,59,"2,5",Basel-Stadt,4058,1634,1033,-601,-240,"17,5"
2958,85,"3,5",Wallis,1950,1800,1126,-674,-193,"13,25"
2959,43,"2,5",Wallis,1920,1100,619,-481,-192,"14,4"
2960,46,"2,5",Wallis,1950,1400,662,-738,-295,"14,4"
2961,92,"4,5",Wallis,1920,1690,1168,-522,-116,"12,7"
2962,110,"4,5",Bern,2720,1490,1524,34,8,"13,85"
2967,82,"3,5",Bern,2556,1880,1173,-707,-202,"14,3"
2968,60,3,Bern,2504,1190,870,-320,-107,"14,5"
2969,150,"3,5",Bern,2502,2150,2145,-5,-1,"14,3"
2973,144,"3,5",Bern,2520,1995,2059,64,18,"14,3"
2973,144,"3,5",Neuchâtel,2520,1995,1721,-274,-78,"11,95"
2974,100,"4,5",Bern,2720,1450,1385,-65,-14,"13,85"
2981,73,"2,5",Bern,2502,1550,1084,-466,-186,"14,85"
2986,130,"4,5",Waadt,1024,2840,2119,-721,-160,"16,3"
2987,200,6,Genf,1233,4900,4520,-380,-63,"22,6"
2989,46,2,Genf,1223,2600,865,-1735,-868,"18,8"
2990,52,"2,5",Genf,1206,3000,970,-2030,-812,"18,65"
2991,53,"2,5",Genf,1207,2600,988,-1612,-645,"18,65"
2992,125,4,Genf,1218,3185,2263,-922,-231,"18,1"
2993,161,6,Genf,1218,3800,3639,-161,-27,"22,6"
2995,120,5,Genf,1213,3690,2220,-1470,-294,"18,5"
2998,80,"4,5",Waadt,1123,1800,1304,-496,-110,"16,3"
2999,77,"3,5",Basel-Landschaft,4104,1720,1267,-453,-129,"16,45"
3000,104,4,Luzern,6004,2248,1477,-771,-193,"14,2"
3001,61,3,Basel-Landschaft,4132,1495,1019,-476,-159,"16,7"
3004,78,"2,5",Zürich,8152,1925,1537,-388,-155,"19,7"
3005,67,"2,5",Zürich,8050,2520,1320,-1200,-480,"19,7"
3007,131,"4,5",Tessin,6514,2150,1814,-336,-75,"13,85"
3010,110,3,Zürich,8932,1450,2057,607,202,"18,7"
3011,87,"3,5",Zürich,8810,1780,1575,-205,-59,"18,1"
3012,68,"3,5",Bern,3072,1530,972,-558,-159,"14,3"
3016,61,"2,5",Aargau,5330,1110,949,-161,-64,"15,55"
3017,70,"3,5",St. Gallen,9306,1540,970,-570,-163,"13,85"
3017,70,"3,5",Thurgau,9306,1540,935,-605,-173,"13,35"
3018,71,3,Zürich,8307,1630,1328,-302,-101,"18,7"
3019,132,"5,5",Zürich,8910,2351,2356,5,1,"17,85"
3020,82,"3,5",Aargau,5036,1680,1205,-475,-136,"14,7"
3021,82,"3,5",Aargau,5036,1780,1205,-575,-164,"14,7"
3022,93,"3,5",Aargau,5036,1780,1367,-413,-118,"14,7"
3023,130,"5,5",St. Gallen,8645,3090,1632,-1458,-265,"12,55"
3024,82,"3,5",Zug,6330,2270,1570,-700,-200,"19,15"
3025,80,"3,5",Basel-Landschaft,4414,1720,1316,-404,-115,"16,45"
3026,51,2,Waadt,1800,1280,933,-347,-174,"18,3"
3028,17,1,Zürich,8910,830,371,-459,-459,"21,8"
3029,49,"2,5",Waadt,1400,1115,867,-248,-99,"17,7"
3030,66,3,Schaffhausen,8200,1090,891,-199,-66,"13,5"
3033,142,"5,5",Zürich,8405,2555,2535,-20,-4,"17,85"
3034,73,4,Zürich,8810,1790,1278,-512,-128,"17,5"
3035,91,"3,5",Waadt,1800,2100,1502,-598,-171,"16,5"
3038,148,"4,5",Nidwalden,6370,2950,2220,-730,-162,15
3039,30,1,Basel-Landschaft,4147,680,510,-170,-170,17
3040,70,"3,5",Glarus,8867,1121,889,-232,-66,"12,7"
3041,118,"3,5",Zürich,8477,2140,2136,-4,-1,"18,1"
3043,12,1,Aargau,5210,505,196,-309,-309,"16,3"
3044,145,"5,5",Schaffhausen,8260,1760,1943,183,33,"13,4"
3045,110,"4,5",Bern,3177,1660,1524,-136,-30,"13,85"
3046,111,"4,5",Bern,4950,1740,1537,-203,-45,"13,85"
3048,140,"3,5",Schaffhausen,8260,2180,1841,-339,-97,"13,15"
3049,134,"5,5",Luzern,6045,3300,1896,-1404,-255,"14,15"
3050,129,"5,5",Waadt,1053,3000,2193,-807,-147,17
3055,166,"5,5",Schwyz,6403,2990,2698,-292,-53,"16,25"
3056,92,"3,5",Schwyz,6403,1750,1486,-264,-75,"16,15"
3057,93,"4,5",Luzern,6232,1520,1316,-204,-45,"14,15"
3058,85,"3,5",Freiburg,1749,1500,1203,-297,-85,"14,15"
3059,28,1,Waadt,1020,1210,596,-614,-614,"21,3"
3062,81,"3,5",Wallis,1920,1510,1073,-437,-125,"13,25"
3063,86,"5,5",Genf,1224,2990,1767,-1223,-222,"20,55"
3065,105,"3,5",Nidwalden,6374,1580,1669,89,25,"15,9"
3066,140,"4,5",Zürich,8001,5500,2457,-3043,-676,"17,55"
3067,17,1,Luzern,6003,985,320,-665,-665,"18,8"
3069,140,"5,5",Wallis,3960,2450,1876,-574,-104,"13,4"
3070,10,1,Luzern,6003,665,188,-477,-477,"18,8"
3072,116,"3,5",Bern,4536,1950,1659,-291,-83,"14,3"
3073,90,"3,5",Appenzell Ausserrhoden,9113,1345,1148,-197,-56,"12,75"
3073,90,"3,5",St. Gallen,9113,1345,1247,-98,-28,"13,85"
3075,85,3,Zürich,8712,1911,1590,-321,-107,"18,7"
3076,88,"3,5",Zürich,8400,2313,1593,-720,-206,"18,1"
3077,98,"3,5",Zürich,8166,1870,1774,-96,-27,"18,1"
3080,10,1,Luzern,6003,655,188,-467,-467,"18,8"
3082,60,"2,5",Tessin,6515,1230,801,-429,-172,"13,35"
3083,165,"4,5",Basel-Landschaft,4410,3050,2723,-327,-73,"16,5"
3084,71,"3,5",Zürich,8307,1280,1285,5,1,"18,1"
3085,10,1,Luzern,6003,710,188,-522,-522,"18,8"
3087,65,"2,5",Thurgau,9542,1450,920,-530,-212,"14,15"
3090,158,"4,5",Zürich,8355,2390,2773,383,85,"17,55"
3090,158,"4,5",Thurgau,8355,2390,1951,-439,-98,"12,35"
3095,30,"1,5",Aargau,5610,750,484,-266,-177,"16,15"
3096,30,"1,5",Aargau,5200,750,484,-266,-177,"16,15"
3097,100,"3,5",Zürich,8635,1638,1810,172,49,"18,1"
3100,76,"3,5",Zürich,8245,1820,1376,-444,-127,"18,1"
3101,36,"1,5",Thurgau,8280,1080,508,-572,-381,"14,1"
3102,70,3,Zürich,8057,1950,1309,-641,-214,"18,7"
3103,110,"4,5",St. Gallen,9105,1395,1436,41,9,"13,05"
3103,110,"4,5",Appenzell Ausserrhoden,9105,1395,1348,-47,-10,"12,25"
3104,58,2,Tessin,6830,850,766,-84,-42,"13,2"
3105,84,"3,5",Luzern,6280,1980,1243,-737,-211,"14,8"
3106,60,3,Genf,1207,2825,1110,-1715,-572,"18,5"
3108,90,"3,5",Tessin,6855,1050,1215,165,47,"13,5"
3112,17,1,Zürich,8003,1050,371,-679,-679,"21,8"
3115,33,"1,5",Zürich,8600,1530,701,-829,-553,"21,25"
3116,117,"4,5",Waadt,1326,2210,1907,-303,-67,"16,3"
3118,48,"1,5",Tessin,6830,745,598,-147,-98,"12,45"
3122,90,"4,5",Aargau,4800,1600,1283,-317,-70,"14,25"
3123,59,"2,5",Thurgau,8500,1330,835,-495,-198,"14,15"
3123,59,"2,5",Zürich,8500,1330,1162,-168,-67,"19,7"
3125,78,"3,5",Luzern,6243,1480,1154,-326,-93,"14,8"
3127,58,"2,5",Thurgau,8500,1440,821,-619,-248,"14,15"
3127,58,"2,5",Zürich,8500,1440,1143,-297,-119,"19,7"
3128,88,"3,5",Zürich,8408,2150,1593,-557,-159,"18,1"
3129,94,"4,5",Zürich,8408,2520,1650,-870,-193,"17,55"
3130,97,"4,5",Zürich,8408,2540,1702,-838,-186,"17,55"
3131,74,"2,5",Zürich,8408,1870,1458,-412,-165,"19,7"
3132,69,"2,5",Zürich,8408,1870,1359,-511,-204,"19,7"
3133,73,"2,5",Zürich,8408,1910,1438,-472,-189,"19,7"
3134,98,"3,5",Zürich,8408,2380,1774,-606,-173,"18,1"
3135,81,"3,5",Zürich,8408,2120,1466,-654,-187,"18,1"
3136,61,"2,5",Bern,3400,960,906,-54,-22,"14,85"
3138,67,"2,5",Zürich,8052,1885,1320,-565,-226,"19,7"
3139,80,"2,5",Waadt,1337,1480,1416,-64,-26,"17,7"
3141,28,1,Zürich,8002,1050,610,-440,-440,"21,8"
3142,143,"5,5",Zürich,8704,4870,2553,-2317,-421,"17,85"
3146,110,"4,5",St. Gallen,9000,1690,1436,-254,-56,"13,05"
3147,60,"3,5",Bern,3855,1750,858,-892,-255,"14,3"
3148,25,"1,5",Bern,3855,750,390,-360,-240,"15,6"
3149,73,2,Basel-Landschaft,4153,1620,1248,-372,-186,"17,1"
3151,85,"4,5",Jura,2822,1150,876,-274,-61,"10,3"
3155,42,2,Basel-Landschaft,4402,1180,718,-462,-231,"17,1"
3156,65,"2,5",Waadt,1376,1396,1151,-245,-98,"17,7"
3157,33,1,Freiburg,1618,860,601,-259,-259,"18,2"
3158,122,"4,5",Aargau,4310,2510,1739,-771,-171,"14,25"
3159,61,"2,5",Luzern,6208,1510,982,-528,-211,"16,1"
3161,26,1,Waadt,1337,350,554,204,204,"21,3"
3162,90,"4,5",St. Gallen,9532,1570,1175,-395,-88,"13,05"
3162,90,"4,5",Thurgau,9532,1570,1112,-458,-102,"12,35"
3163,80,"2,5",Basel-Landschaft,4458,1700,1352,-348,-139,"16,9"
3164,86,"3,5",Basel-Landschaft,4458,1750,1415,-335,-96,"16,45"
3165,65,"2,5",Basel-Landschaft,4458,1500,1099,-401,-160,"16,9"
3166,66,"2,5",Basel-Landschaft,4458,1600,1115,-485,-194,"16,9"
3167,68,"2,5",Basel-Landschaft,4458,1600,1149,-451,-180,"16,9"
3168,85,"4,5",St. Gallen,9100,1425,1109,-316,-70,"13,05"
3168,85,"4,5",Appenzell Ausserrhoden,9100,1425,1041,-384,-85,"12,25"
3169,20,1,Zürich,8004,1100,436,-664,-664,"21,8"
3170,90,"4,5",St. Gallen,9532,1570,1175,-395,-88,"13,05"
3170,90,"4,5",Thurgau,9532,1570,1112,-458,-102,"12,35"
3171,91,"3,5",Waadt,1350,1910,1502,-408,-117,"16,5"
3174,65,3,Zürich,8048,1850,1216,-634,-211,"18,7"
3175,103,"3,5",Zürich,8700,3800,1864,-1936,-553,"18,1"
3177,46,"2,5",Waadt,1260,1650,814,-836,-334,"17,7"
3178,130,"4,5",Waadt,1005,4200,2119,-2081,-462,"16,3"
3181,35,2,Genf,1227,1294,658,-636,-318,"18,8"
3184,101,"3,5",St. Gallen,9445,1710,1399,-311,-89,"13,85"
3186,120,4,Graubünden,7240,1570,1776,206,52,"14,8"
3187,38,1,Graubünden,7000,800,711,-89,-89,"18,7"
3188,117,"4,5",St. Gallen,9445,2070,1527,-543,-121,"13,05"
3194,109,"4,5",Thurgau,9500,1890,1346,-544,-121,"12,35"
3194,109,"4,5",St. Gallen,9500,1890,1422,-468,-104,"13,05"
3195,68,"2,5",St. Gallen,9445,1480,1013,-467,-187,"14,9"
3196,40,1,Aargau,5502,680,652,-28,-28,"16,3"
3197,107,"4,5",Luzern,6252,1810,1514,-296,-66,"14,15"
3198,79,"4,5",Graubünden,7302,1282,1067,-215,-48,"13,5"
3199,100,"4,5",St. Gallen,7323,1220,1305,85,19,"13,05"
3200,122,"5,5",St. Gallen,9445,2190,1531,-659,-120,"12,55"
3201,105,"4,5",Aargau,5303,1980,1496,-484,-108,"14,25"
3203,80,"3,5",Luzern,6005,1670,1184,-486,-139,"14,8"
3206,65,"2,5",Schwyz,6423,1459,1108,-351,-140,"17,05"
3207,84,"3,5",Zug,6300,2900,1609,-1291,-369,"19,15"
3208,83,"4,5",Aargau,8965,1640,1183,-457,-102,"14,25"
3209,31,1,Waadt,1005,1155,660,-495,-495,"21,3"
3210,31,1,Waadt,1003,840,660,-180,-180,"21,3"
3211,42,2,Waadt,1004,970,769,-201,-101,"18,3"
3212,60,"3,5",Waadt,1008,1510,990,-520,-149,"16,5"
3213,62,3,Waadt,1004,1395,1060,-335,-112,"17,1"
3214,160,"4,5",Zürich,8953,2550,2808,258,57,"17,55"
3214,160,"4,5",Aargau,8953,2550,2280,-270,-60,"14,25"
3215,75,4,Genf,1212,1980,1358,-622,-156,"18,1"
3216,35,2,Genf,1227,1294,658,-636,-318,"18,8"
3217,30,1,Basel-Landschaft,4153,800,510,-290,-290,17
3218,30,1,Basel-Landschaft,4153,800,510,-290,-290,17
3220,130,"4,5",Waadt,1005,4200,2119,-2081,-462,"16,3"
3228,48,"1,5",Appenzell Ausserrhoden,9012,950,756,-194,-129,"15,75"
3228,48,"1,5",St. Gallen,9012,950,751,-199,-133,"15,65"
3235,71,"3,5",Appenzell Ausserrhoden,9012,1450,905,-545,-156,"12,75"
3235,71,"3,5",St. Gallen,9012,1450,983,-467,-133,"13,85"
3242,29,1,Appenzell Ausserrhoden,9012,720,479,-241,-241,"16,5"
3242,29,1,St. Gallen,9012,720,461,-259,-259,"15,9"
3243,52,"1,5",Appenzell Ausserrhoden,9012,975,819,-156,-104,"15,75"
3243,52,"1,5",St. Gallen,9012,975,814,-161,-107,"15,65"
3245,71,"3,5",Appenzell Ausserrhoden,9012,1450,905,-545,-156,"12,75"
3245,71,"3,5",St. Gallen,9012,1450,983,-467,-133,"13,85"
3249,140,"5,5",Thurgau,8570,1800,1659,-141,-26,"11,85"
3250,164,"5,5",Zürich,8044,4052,2927,-1125,-205,"17,85"
3252,70,3,Zürich,8604,1485,1309,-176,-59,"18,7"
3253,149,"4,5",Solothurn,4500,2470,1922,-548,-122,"12,9"
3254,160,"4,5",Thurgau,8266,3820,1976,-1844,-410,"12,35"
3255,90,"4,5",Thurgau,8592,1750,1112,-638,-142,"12,35"
3256,160,"4,5",Thurgau,8266,3820,1976,-1844,-410,"12,35"
3257,180,5,Thurgau,8592,5000,2142,-2858,-572,"11,9"
3264,55,"2,5",Graubünden,7000,1380,872,-508,-203,"15,85"
3265,72,1,Luzern,6210,1800,1354,-446,-446,"18,8"
3270,75,"3,5",Graubünden,7130,1580,1129,-451,-129,"15,05"
3271,75,"2,5",St. Gallen,9400,1490,1118,-372,-149,"14,9"
3272,90,"3,5",St. Gallen,9445,1570,1247,-323,-92,"13,85"
3273,102,"4,5",St. Gallen,9445,1910,1331,-579,-129,"13,05"
3274,66,"2,5",St. Gallen,9445,1250,983,-267,-107,"14,9"
3276,76,"2,5",Luzern,6003,2380,1224,-1156,-462,"16,1"
3277,125,"4,5",Graubünden,7504,3250,1688,-1562,-347,"13,5"
3279,35,1,Zürich,8305,998,763,-235,-235,"21,8"
3280,110,"4,5",St. Gallen,9000,1450,1436,-14,-3,"13,05"
3281,10,1,Zürich,8833,650,218,-432,-432,"21,8"
3281,10,1,Schwyz,8833,650,179,-471,-471,"17,9"
3284,49,2,Uri,6472,830,657,-173,-87,"13,4"
3287,114,"5,5",St. Gallen,8890,1650,1431,-219,-40,"12,55"
3289,15,1,St. Gallen,9014,399,239,-160,-160,"15,9"
3289,15,1,Appenzell Ausserrhoden,9014,399,248,-151,-151,"16,5"
3290,104,"4,5",Glarus,8762,1570,1258,-312,-69,"12,1"
3292,78,3,Zürich,8355,1350,1459,109,36,"18,7"
3292,78,3,Thurgau,8355,1350,1084,-266,-89,"13,9"
3294,80,4,St. Gallen,9403,1390,1064,-326,-82,"13,3"
3296,135,"4,5",Schwyz,6410,2900,2113,-787,-175,"15,65"
3297,68,"2,5",Schwyz,6410,1720,1159,-561,-224,"17,05"
3300,40,"1,5",St. Gallen,9037,600,626,26,17,"15,65"
3300,40,"1,5",Appenzell Ausserrhoden,9037,600,630,30,20,"15,75"
3302,80,4,Graubünden,7000,1810,1184,-626,-157,"14,8"
3303,130,"3,5",Basel-Landschaft,4419,1640,2139,499,143,"16,45"
3304,35,1,Schwyz,6422,1000,627,-373,-373,"17,9"
3305,70,3,Solothurn,4114,1600,952,-648,-216,"13,6"
3306,108,"5,5",St. Gallen,9244,2390,1355,-1035,-188,"12,55"
3308,67,"3,5",Solothurn,2545,1290,888,-402,-115,"13,25"
3309,44,2,Graubünden,7222,740,722,-18,-9,"16,4"
3310,90,"2,5",Luzern,6280,1490,1449,-41,-16,"16,1"
3311,139,6,Appenzell Innerrhoden,9056,1480,2099,619,103,"15,1"
3311,139,6,Appenzell Ausserrhoden,9056,1480,1501,21,4,"10,8"
3312,100,"3,5",Graubünden,7000,1880,1505,-375,-107,"15,05"
3313,162,5,Appenzell Innerrhoden,9056,1900,2041,141,28,"12,6"
3313,162,5,Appenzell Ausserrhoden,9056,1900,1912,12,2,"11,8"
3315,118,"3,5",Appenzell Innerrhoden,9056,1425,1652,227,65,14
3315,118,"3,5",Appenzell Ausserrhoden,9056,1425,1505,80,23,"12,75"
3316,105,"4,5",Luzern,6024,1960,1486,-474,-105,"14,15"
3317,126,"3,5",Appenzell Innerrhoden,9056,1525,1764,239,68,14
3317,126,"3,5",Appenzell Ausserrhoden,9056,1525,1607,82,23,"12,75"
3319,22,1,Appenzell Ausserrhoden,9042,615,363,-252,-252,"16,5"
3319,22,1,St. Gallen,9042,615,350,-265,-265,"15,9"
3322,90,"4,5",Tessin,6982,1800,1247,-553,-123,"13,85"
3324,145,"4,5",Zürich,8620,2850,2545,-305,-68,"17,55"
3325,101,"3,5",Aargau,4332,2250,1485,-765,-219,"14,7"
3326,65,3,Aargau,5634,1380,982,-398,-133,"15,1"
3328,90,"4,5",Luzern,6004,1720,1273,-447,-99,"14,15"
3329,15,1,Appenzell Ausserrhoden,9405,570,248,-322,-322,"16,5"
3329,15,1,St. Gallen,9405,570,239,-331,-331,"15,9"
3331,95,"4,5",St. Gallen,9230,1130,1240,110,24,"13,05"
3332,85,3,Graubünden,7430,1100,1301,201,67,"15,3"
3333,68,"3,5",Waadt,1815,2050,1122,-928,-265,"16,5"
3334,117,"3,5",Zürich,8600,2660,2118,-542,-155,"18,1"
3335,72,3,Zürich,8038,2115,1346,-769,-256,"18,7"
3337,68,"3,5",Bern,3063,1610,972,-638,-182,"14,3"
3338,102,"4,5",Bern,3063,1970,1413,-557,-124,"13,85"
3339,90,"3,5",Schaffhausen,8200,1730,1184,-546,-156,"13,15"
3342,67,"3,5",Aargau,8964,1480,985,-495,-141,"14,7"
3344,110,"3,5",St. Gallen,9533,1350,1524,174,50,"13,85"
3345,84,"3,5",Thurgau,9565,1880,1121,-759,-217,"13,35"
3346,137,"4,5",Thurgau,9556,2259,1692,-567,-126,"12,35"
3347,102,"4,5",Thurgau,9553,1845,1260,-585,-130,"12,35"
3349,104,"4,5",Thurgau,9553,1910,1284,-626,-139,"12,35"
3350,118,"4,5",St. Gallen,9606,1905,1540,-365,-81,"13,05"
3351,26,1,Zürich,8006,1500,567,-933,-933,"21,8"
3352,60,"2,5",Obwalden,6010,1430,858,-572,-229,"14,3"
3352,60,"2,5",Nidwalden,6010,1430,999,-431,-172,"16,65"
3352,60,"2,5",Luzern,6010,1430,966,-464,-186,"16,1"
3353,62,3,Zürich,8002,2490,1159,-1331,-444,"18,7"
3354,105,"4,5",Tessin,6986,1510,1454,-56,-12,"13,85"
3358,137,"5,5",Aargau,5430,2630,1939,-691,-126,"14,15"
3359,28,1,Basel-Stadt,4058,1000,490,-510,-510,"17,5"
3360,232,"5,5",Basel-Landschaft,4105,3800,4083,283,51,"17,6"
3361,103,"4,5",Basel-Stadt,4051,2550,1751,-799,-178,17
3367,92,"4,5",Basel-Stadt,4058,2320,1564,-756,-168,17
3369,50,2,Basel-Stadt,4055,1700,910,-790,-395,"18,2"
3371,84,3,Basel-Stadt,4056,2120,1411,-709,-236,"16,8"
3372,168,"5,5",Zürich,8616,2450,2999,549,100,"17,85"
3375,25,1,Schwyz,8640,1000,447,-553,-553,"17,9"
3375,25,1,St. Gallen,8640,1000,398,-602,-602,"15,9"
3376,97,"4,5",St. Gallen,9000,1640,1266,-374,-83,"13,05"
3377,18,1,Bern,3004,1000,288,-712,-712,16
3379,77,"4,5",Genf,1203,2415,1409,-1006,-224,"18,3"
3380,80,4,Genf,1201,2620,1448,-1172,-293,"18,1"
3382,18,1,Zürich,8001,1200,392,-808,-808,"21,8"
3385,80,3,Zürich,8820,1542,1496,-46,-15,"18,7"
3386,90,3,Waadt,1276,2290,1539,-751,-250,"17,1"
3387,75,3,Solothurn,4600,1265,1020,-245,-82,"13,6"
3387,75,3,Aargau,4600,1265,1133,-132,-44,"15,1"
3388,84,"3,5",Solothurn,4625,1600,1113,-487,-139,"13,25"
3389,65,"3,5",Solothurn,4657,1165,861,-304,-87,"13,25"
3390,49,"2,5",Schwyz,8846,1090,835,-255,-102,"17,05"
3392,58,"2,5",Zürich,8302,1470,1143,-327,-131,"19,7"
3399,72,3,Zürich,8052,1928,1346,-582,-194,"18,7"
3400,30,2,St. Gallen,9000,850,462,-388,-194,"15,4"
3401,100,4,Zug,6300,2690,1880,-810,-203,"18,8"
3403,22,1,Bern,3176,635,352,-283,-283,16
3403,22,1,Freiburg,3176,635,400,-235,-235,"18,2"
3405,95,"5,5",Solothurn,4563,1250,1240,-10,-2,"13,05"
3407,96,"3,5",Luzern,6110,1490,1421,-69,-20,"14,8"
3409,60,"2,5",Wallis,1997,950,864,-86,-34,"14,4"
3413,82,"3,5",Aargau,5622,1555,1205,-350,-100,"14,7"
3415,57,2,Zürich,8180,1440,1180,-260,-130,"20,7"
3416,105,"4,5",Luzern,6037,2120,1486,-634,-141,"14,15"
3417,88,"3,5",Luzern,6037,1880,1302,-578,-165,"14,8"
3418,82,"3,5",Luzern,6037,1695,1214,-481,-137,"14,8"
3420,50,"2,5",Zürich,8053,1590,985,-605,-242,"19,7"
3421,127,"4,5",Aargau,5637,1990,1810,-180,-40,"14,25"
3422,50,2,Luzern,6023,975,840,-135,-68,"16,8"
3423,44,2,Luzern,6030,1250,739,-511,-256,"16,8"
3424,100,4,Zug,6300,2830,1880,-950,-238,"18,8"
3427,45,2,Aargau,5300,1050,720,-330,-165,16
3428,38,"1,5",Zürich,8052,1495,808,-687,-458,"21,25"
3430,127,"5,5",Aargau,5622,2270,1797,-473,-86,"14,15"
3433,71,"3,5",Graubünden,7013,1350,1069,-281,-80,"15,05"
3435,65,"2,5",Zürich,8001,2850,1281,-1569,-628,"19,7"
3436,30,1,Zürich,8006,1900,654,-1246,-1246,"21,8"
3437,103,"3,5",Zürich,8951,2200,1864,-336,-96,"18,1"
3439,65,3,Zürich,8400,1510,1216,-294,-98,"18,7"
3440,51,"2,5",Aargau,5600,1260,793,-467,-187,"15,55"
3441,127,"5,5",Aargau,5622,2270,1797,-473,-86,"14,15"
3442,150,"4,5",Graubünden,7278,2300,2025,-275,-61,"13,5"
3443,95,"4,5",Thurgau,9214,1595,1173,-422,-94,"12,35"
3444,50,2,Basel-Stadt,4058,1980,910,-1070,-535,"18,2"
3445,110,4,Bern,3125,1580,1551,-29,-7,"14,1"
3446,35,1,Aargau,4312,670,571,-99,-99,"16,3"
3448,105,"4,5",Basel-Landschaft,4304,2080,1733,-347,-77,"16,5"
3450,75,4,Basel-Landschaft,4436,1400,1215,-185,-46,"16,2"
3452,80,"3,5",Aargau,5036,1830,1176,-654,-187,"14,7"
3454,54,"2,5",Zürich,8166,1490,1064,-426,-170,"19,7"
3461,69,3,Basel-Landschaft,4147,1430,1152,-278,-93,"16,7"
3462,61,"2,5",Zürich,8953,1550,1202,-348,-139,"19,7"
3462,61,"2,5",Aargau,8953,1550,949,-601,-240,"15,55"
3464,110,"3,5",Basel-Landschaft,4147,2280,1810,-470,-134,"16,45"
3465,76,"3,5",Solothurn,4657,1180,1007,-173,-49,"13,25"
3466,139,"4,5",Basel-Landschaft,4304,2130,2294,164,36,"16,5"
3467,139,"4,5",Basel-Landschaft,4304,2080,2294,214,48,"16,5"
3469,139,"4,5",Basel-Landschaft,4304,2180,2294,114,25,"16,5"
3470,90,4,Basel-Stadt,4125,1950,1503,-447,-112,"16,7"
3471,85,4,Zürich,8045,3950,1488,-2462,-616,"17,5"
3472,70,3,Zürich,8047,3000,1309,-1691,-564,"18,7"
3473,55,2,Zürich,8047,2750,1139,-1611,-806,"20,7"
3474,109,"4,5",Freiburg,1673,2010,1472,-538,-120,"13,5"
3475,71,"3,5",Freiburg,1742,1250,1005,-245,-70,"14,15"
3476,83,"3,5",Nidwalden,6373,1850,1320,-530,-151,"15,9"
3477,125,"4,5",Nidwalden,6382,2160,1875,-285,-63,15
3478,176,"5,5",Luzern,6048,4600,2490,-2110,-384,"14,15"
3479,184,"4,5",Nidwalden,6373,3700,2760,-940,-209,15
3480,132,"5,5",Obwalden,6072,2375,1657,-718,-131,"12,55"
3481,63,3,Waadt,1820,1660,1077,-583,-194,"17,1"
3483,200,3,Aargau,5445,1980,3020,1040,347,"15,1"
3484,74,"2,5",Aargau,4663,1600,1151,-449,-180,"15,55"
3484,74,"2,5",Solothurn,4663,1600,1018,-582,-233,"13,75"
3485,63,3,Schaffhausen,8200,1185,851,-334,-111,"13,5"
3486,85,"3,5",Aargau,5412,1790,1250,-540,-154,"14,7"
3487,96,"4,5",Zürich,8046,2200,1685,-515,-114,"17,55"
3489,75,"3,5",Thurgau,8280,1380,1001,-379,-108,"13,35"
3490,32,1,Basel-Landschaft,4052,1363,544,-819,-819,17
3490,32,1,Basel-Stadt,4052,1363,560,-803,-803,"17,5"
3492,105,"4,5",Thurgau,8570,1580,1297,-283,-63,"12,35"
3494,50,2,Basel-Landschaft,4153,1320,855,-465,-233,"17,1"
3496,89,"3,5",Aargau,5630,1859,1308,-551,-157,"14,7"
3497,55,2,Zürich,8903,1590,1139,-451,-226,"20,7"
3499,130,"3,5",Zürich,8304,2390,2353,-37,-11,"18,1"
3500,85,4,Zürich,8307,1790,1488,-302,-76,"17,5"
3503,67,"3,5",Appenzell Innerrhoden,9050,1810,938,-872,-249,14
3504,65,"2,5",Tessin,6900,1550,868,-682,-273,"13,35"
3505,147,"4,5",Zürich,8134,3455,2580,-875,-194,"17,55"
3508,66,"2,5",Aargau,8919,1400,1026,-374,-150,"15,55"
3509,39,"1,5",Zürich,8406,1320,829,-491,-327,"21,25"
3511,77,"3,5",Bern,3084,1730,1101,-629,-180,"14,3"
3513,30,1,Zürich,8406,1190,654,-536,-536,"21,8"
3515,76,3,Zürich,8700,1910,1421,-489,-163,"18,7"
3516,125,"5,5",Bern,3432,2160,1694,-466,-85,"13,55"
3517,116,2,Solothurn,4553,1440,1612,172,86,"13,9"
3518,109,"4,5",Bern,3432,1780,1510,-270,-60,"13,85"
3520,108,"4,5",Bern,3400,1940,1496,-444,-99,"13,85"
3530,84,3,Bern,3006,1730,1218,-512,-171,"14,5"
3532,66,3,Bern,2553,1440,957,-483,-161,"14,5"
3534,109,"2,5",Luzern,6003,2380,1755,-625,-250,"16,1"
3535,72,"3,5",Thurgau,8500,1554,961,-593,-169,"13,35"
3535,72,"3,5",Zürich,8500,1554,1303,-251,-72,"18,1"
3536,60,3,Tessin,6652,850,810,-40,-13,"13,5"
3540,119,"3,5",Aargau,5610,2300,1749,-551,-157,"14,7"
3543,80,"3,5",Thurgau,8370,1170,1068,-102,-29,"13,35"
3544,105,"2,5",Solothurn,4533,1850,1444,-406,-162,"13,75"
3545,104,"4,5",Appenzell Ausserrhoden,9113,1170,1274,104,23,"12,25"
3545,104,"4,5",St. Gallen,9113,1170,1357,187,42,"13,05"
3546,35,1,St. Gallen,9400,700,557,-143,-143,"15,9"
3547,76,"3,5",Uri,6460,1620,977,-643,-184,"12,85"
3548,74,"3,5",Zürich,8603,1780,1339,-441,-126,"18,1"
3549,45,2,Zürich,8603,1495,932,-563,-282,"20,7"
3551,138,"5,5",Genf,1208,4800,2836,-1964,-357,"20,55"
3552,59,"3,5",Tessin,6900,1390,797,-593,-169,"13,5"
3553,122,"3,5",Basel-Stadt,4051,3230,2044,-1186,-339,"16,75"
3554,130,"4,5",Freiburg,1630,2000,1755,-245,-54,"13,5"
3555,160,"4,5",Zürich,8703,4831,2808,-2023,-450,"17,55"
3556,110,"2,5",Zürich,8134,2425,2167,-258,-103,"19,7"
3557,110,5,Bern,3612,2150,1496,-654,-131,"13,6"
3558,105,"4,5",Schwyz,8835,2079,1643,-436,-97,"15,65"
3559,57,"2,5",Waadt,1820,2280,1009,-1271,-508,"17,7"
3561,113,"3,5",Schwyz,6403,2665,1825,-840,-240,"16,15"
3563,65,3,Zürich,8038,2500,1216,-1284,-428,"18,7"
3564,57,"2,5",Solothurn,4710,995,784,-211,-84,"13,75"
3567,99,"3,5",St. Gallen,8733,1675,1371,-304,-87,"13,85"
3568,125,6,Thurgau,9500,1790,1475,-315,-53,"11,8"
3568,125,6,St. Gallen,9500,1790,1538,-252,-42,"12,3"
3569,10,1,Zürich,8833,650,218,-432,-432,"21,8"
3569,10,1,Schwyz,8833,650,179,-471,-471,"17,9"
3570,40,2,Zürich,8802,1200,828,-372,-186,"20,7"
3571,30,"1,5",Aargau,5620,750,484,-266,-177,"16,15"
3575,106,"4,5",Schaffhausen,8213,1380,1383,3,1,"13,05"
3579,100,"5,5",Zürich,8625,1978,1785,-193,-35,"17,85"
3580,85,"4,5",Zürich,8625,1757,1492,-265,-59,"17,55"
3582,35,"1,5",Luzern,6005,1240,623,-617,-411,"17,8"
3584,20,1,Schwyz,8807,950,358,-592,-592,"17,9"
3585,142,4,Zürich,8400,3530,2485,-1045,-261,"17,5"
3589,170,"4,5",Schaffhausen,8200,2265,2219,-46,-10,"13,05"
3591,92,"4,5",Zürich,8600,2580,1615,-965,-214,"17,55"
3592,88,"4,5",Zürich,8330,2370,1544,-826,-184,"17,55"
3596,150,"4,5",Aargau,5620,2420,2138,-282,-63,"14,25"
3597,62,"2,5",Zürich,8152,1695,1221,-474,-190,"19,7"
3615,35,2,Genf,1205,1500,658,-842,-421,"18,8"
3620,16,1,Zürich,8004,1128,349,-779,-779,"21,8"
3622,52,"2,5",Solothurn,4500,1210,715,-495,-198,"13,75"
3629,15,1,Basel-Stadt,4058,790,263,-527,-527,"17,5"
3631,20,1,Zürich,8057,1350,436,-914,-914,"21,8"
3632,68,"3,5",Zürich,8704,1800,1231,-569,-163,"18,1"
3637,88,"3,5",Solothurn,4623,1425,1166,-259,-74,"13,25"
3639,20,1,Zürich,8057,845,436,-409,-409,"21,8"
3643,86,2,Bern,3507,1150,1307,157,79,"15,2"
3645,26,"1,5",Aargau,5200,920,420,-500,-333,"16,15"
3646,84,"3,5",Aargau,5200,1890,1235,-655,-187,"14,7"
3647,56,"2,5",Aargau,5200,1450,871,-579,-232,"15,55"
3648,80,"3,5",Wallis,3902,1580,1060,-520,-149,"13,25"
3649,95,"4,5",Aargau,4856,1500,1354,-146,-32,"14,25"
3650,90,"3,5",Zürich,8610,2280,1629,-651,-186,"18,1"
3651,105,"5,5",Obwalden,6010,2200,1318,-882,-160,"12,55"
3651,105,"5,5",Nidwalden,6010,2200,1544,-656,-119,"14,7"
3651,105,"5,5",Luzern,6010,2200,1486,-714,-130,"14,15"
3652,88,"2,5",Bern,3008,2380,1307,-1073,-429,"14,85"
3653,80,4,Zürich,8050,1980,1400,-580,-145,"17,5"
3654,75,"2,5",Zürich,8038,1429,1478,49,20,"19,7"
3656,70,3,Luzern,6210,1440,1078,-362,-121,"15,4"
3657,44,2,Zürich,8001,2000,911,-1089,-545,"20,7"
3672,107,"4,5",Zürich,8620,1917,1878,-39,-9,"17,55"
3674,42,"2,5",Freiburg,1700,1315,641,-674,-270,"15,25"
3675,62,3,Zürich,8002,2450,1159,-1291,-430,"18,7"
3678,50,3,Zürich,8038,1980,935,-1045,-348,"18,7"
3680,111,"3,5",Zug,6314,1800,2126,326,93,"19,15"
3681,60,3,Bern,3007,1540,870,-670,-223,"14,5"
3685,160,"3,5",Zürich,8307,2000,2896,896,256,"18,1"
3686,102,"4,5",Luzern,6043,1680,1443,-237,-53,"14,15"
3687,74,"3,5",Schaffhausen,8260,1300,973,-327,-93,"13,15"
3688,85,"3,5",Thurgau,8280,1640,1135,-505,-144,"13,35"
3689,118,"4,5",Appenzell Innerrhoden,9054,2130,1510,-620,-138,"12,8"
3690,70,"3,5",Thurgau,8593,1550,935,-615,-176,"13,35"
3691,85,4,Thurgau,8594,1450,1088,-362,-91,"12,8"
3692,100,"4,5",Thurgau,8536,1640,1235,-405,-90,"12,35"
3693,130,"5,5",St. Gallen,9000,2400,1632,-768,-140,"12,55"
3695,91,4,Obwalden,6010,2290,1238,-1052,-263,"13,6"
3695,91,4,Nidwalden,6010,2290,1374,-916,-229,"15,1"
3695,91,4,Luzern,6010,2290,1292,-998,-250,"14,2"
3700,96,"4,5",St. Gallen,9443,1550,1253,-297,-66,"13,05"
3703,125,"4,5",St. Gallen,9436,1875,1631,-244,-54,"13,05"
3704,29,1,Bern,3014,920,464,-456,-456,16
3706,45,"1,5",Wallis,1907,1000,727,-273,-182,"16,15"
3707,91,"3,5",Wallis,1907,2000,1206,-794,-227,"13,25"
3708,88,2,Wallis,1950,1200,1311,111,56,"14,9"
3709,72,2,Wallis,1950,1300,1073,-227,-114,"14,9"
3710,112,3,Wallis,1950,2000,1557,-443,-148,"13,9"
3711,67,"2,5",Waadt,1009,2760,1186,-1574,-630,"17,7"
3716,93,3,Waadt,1660,1810,1590,-220,-73,"17,1"
3717,106,4,Waadt,1660,2086,1685,-401,-100,"15,9"
3718,123,"4,5",Waadt,1052,3190,2005,-1185,-263,"16,3"
3719,77,"2,5",Waadt,1052,1990,1363,-627,-251,"17,7"
3722,24,1,Schaffhausen,8200,540,281,-259,-259,"11,7"
3723,25,1,Bern,3006,780,400,-380,-380,16
3733,69,3,Bern,3152,1000,1001,1,0,"14,5"
3735,145,"3,5",Bern,3656,2050,2074,24,7,"14,3"
3736,28,"1,5",Bern,4950,540,437,-103,-69,"15,6"
3739,144,"5,5",Bern,3174,2500,1951,-549,-100,"13,55"
3740,32,2,St. Gallen,9015,850,493,-357,-179,"15,4"
3742,22,1,Bern,3011,1430,352,-1078,-1078,16
3751,60,"2,5",Bern,3018,1270,891,-379,-152,"14,85"
3752,82,"3,5",Bern,3600,1600,1173,-427,-122,"14,3"
3755,65,3,Bern,3658,1050,943,-107,-36,"14,5"
3756,45,2,Bern,3423,900,684,-216,-108,"15,2"
3757,62,3,Bern,3628,1200,899,-301,-100,"14,5"
3759,219,"5,5",St. Gallen,9470,2280,2748,468,85,"12,55"
3760,16,1,St. Gallen,9000,630,254,-376,-376,"15,9"
3762,30,2,St. Gallen,9000,950,462,-488,-244,"15,4"
3763,115,"5,5",Bern,3537,1720,1558,-162,-29,"13,55"
3765,62,3,Bern,3628,1200,899,-301,-100,"14,5"
3766,96,"3,5",Bern,3612,1780,1373,-407,-116,"14,3"
3769,80,"2,5",Bern,3656,1290,1188,-102,-41,"14,85"
3770,90,3,Bern,3400,1595,1305,-290,-97,"14,5"
3772,140,"5,5",Bern,3110,2500,1897,-603,-110,"13,55"
3779,65,3,Thurgau,9500,1218,904,-314,-105,"13,9"
3779,65,3,St. Gallen,9500,1218,936,-282,-94,"14,4"
3780,47,2,Thurgau,9500,950,677,-273,-137,"14,4"
3780,47,2,St. Gallen,9500,950,724,-226,-113,"15,4"
3781,85,4,Schwyz,8834,1920,1360,-560,-140,16
3783,68,"2,5",Zürich,8953,1750,1340,-410,-164,"19,7"
3783,68,"2,5",Aargau,8953,1750,1057,-693,-277,"15,55"
3784,73,3,Basel-Stadt,4057,1577,1226,-351,-117,"16,8"
3785,70,3,Basel-Stadt,4054,1720,1176,-544,-181,"16,8"
3786,97,"3,5",Zürich,8600,2040,1756,-284,-81,"18,1"
3787,71,3,Zürich,8135,1550,1328,-222,-74,"18,7"
3788,129,"3,5",Zürich,8474,2130,2335,205,59,"18,1"
3789,100,"4,5",Graubünden,7013,1500,1350,-150,-33,"13,5"
3790,26,1,St. Gallen,9400,870,413,-457,-457,"15,9"
3791,91,3,Jura,2900,1150,1028,-122,-41,"11,3"
3792,91,"3,5",St. Gallen,9008,1295,1260,-35,-10,"13,85"
3793,85,"3,5",Graubünden,7402,1450,1279,-171,-49,"15,05"
3794,77,"4,5",Graubünden,7402,1475,1040,-435,-97,"13,5"
3797,79,"3,5",Thurgau,8280,1500,1055,-445,-127,"13,35"
3798,102,"4,5",St. Gallen,9463,1740,1331,-409,-91,"13,05"
3800,92,"3,5",Aargau,5306,1500,1352,-148,-42,"14,7"
3804,78,"3,5",St. Gallen,9010,1490,1080,-410,-117,"13,85"
3807,63,"2,5",St. Gallen,9034,1040,939,-101,-40,"14,9"
3807,63,"2,5",Appenzell Ausserrhoden,9034,1040,876,-164,-66,"13,9"
3808,56,"2,5",Thurgau,9215,1330,792,-538,-215,"14,15"
3809,115,"3,5",Schwyz,8853,2270,1857,-413,-118,"16,15"
3811,81,"2,5",Zürich,8404,1630,1596,-34,-14,"19,7"
3812,52,2,Solothurn,4600,971,723,-248,-124,"13,9"
3812,52,2,Aargau,4600,971,832,-139,-70,16
3813,72,3,St. Gallen,9534,1500,1037,-463,-154,"14,4"
3815,140,"3,5",Schaffhausen,8262,2150,1841,-309,-88,"13,15"
3816,63,"2,5",Aargau,5400,1530,980,-550,-220,"15,55"
3818,50,2,Luzern,6110,920,840,-80,-40,"16,8"
3819,75,"3,5",Luzern,6110,1150,1110,-40,-11,"14,8"
3820,68,3,Thurgau,8537,1150,945,-205,-68,"13,9"
3823,35,1,Zürich,8805,1210,763,-447,-447,"21,8"
3825,52,"2,5",St. Gallen,9403,1390,775,-615,-246,"14,9"
3826,72,3,Basel-Landschaft,4133,1400,1202,-198,-66,"16,7"
3827,76,3,Basel-Landschaft,4132,1508,1269,-239,-80,"16,7"
3830,16,1,Zürich,8004,1128,349,-779,-779,"21,8"
3833,70,"3,5",St. Gallen,9306,1490,970,-520,-149,"13,85"
3833,70,"3,5",Thurgau,9306,1490,935,-555,-159,"13,35"
3835,90,"3,5",St. Gallen,9463,1590,1247,-343,-98,"13,85"
3836,143,"4,5",St. Gallen,9533,2045,1866,-179,-40,"13,05"
3837,78,"3,5",Graubünden,7000,1455,1174,-281,-80,"15,05"
3839,116,"5,5",St. Gallen,9010,2620,1456,-1164,-212,"12,55"
3840,140,"4,5",Zürich,8002,5600,2457,-3143,-698,"17,55"
3841,66,"3,5",Aargau,4802,1200,970,-230,-66,"14,7"
3842,77,"3,5",Solothurn,4600,1400,1020,-380,-109,"13,25"
3842,77,"3,5",Aargau,4600,1400,1132,-268,-77,"14,7"
3843,83,"4,5",Solothurn,4600,1750,1071,-679,-151,"12,9"
3843,83,"4,5",Aargau,4600,1750,1183,-567,-126,"14,25"
3844,77,"3,5",Solothurn,4600,1410,1020,-390,-111,"13,25"
3844,77,"3,5",Aargau,4600,1410,1132,-278,-79,"14,7"
3846,32,2,St. Gallen,9245,800,493,-307,-154,"15,4"
3847,180,"5,5",Appenzell Ausserrhoden,9055,1800,2034,234,43,"11,3"
3847,180,"5,5",Appenzell Innerrhoden,9055,1800,2493,693,126,"13,85"
3848,46,2,Basel-Stadt,4055,1560,837,-723,-362,"18,2"
3849,90,4,St. Gallen,9126,1100,1197,97,24,"13,3"
3850,81,"3,5",Basel-Stadt,4055,2220,1357,-863,-247,"16,75"
3851,70,"4,5",Thurgau,9320,1300,865,-435,-97,"12,35"
3852,62,"2,5",Basel-Stadt,4055,1890,1085,-805,-322,"17,5"
3853,87,3,Basel-Stadt,4059,2050,1462,-588,-196,"16,8"
3854,59,"2,5",Basel-Stadt,4055,1870,1033,-837,-335,"17,5"
3855,53,"2,5",Zürich,8610,1501,1044,-457,-183,"19,7"
3856,118,"4,5",Zug,6340,2815,2213,-602,-134,"18,75"
3857,65,"3,5",Basel-Stadt,4055,2750,1089,-1661,-475,"16,75"
3861,15,1,Basel-Stadt,4058,790,263,-527,-527,"17,5"
3862,57,2,St. Gallen,9016,1045,878,-167,-84,"15,4"
3863,80,4,Zürich,8604,1528,1400,-128,-32,"17,5"
3864,80,"3,5",Zürich,8620,2133,1448,-685,-196,"18,1"
3866,56,2,St. Gallen,9435,1200,862,-338,-169,"15,4"
3868,65,"2,5",Waadt,1804,1265,1151,-114,-46,"17,7"
3869,122,"4,5",Obwalden,6010,2309,1610,-699,-155,"13,2"
3869,122,"4,5",Nidwalden,6010,2309,1830,-479,-106,15
3869,122,"4,5",Luzern,6010,2309,1726,-583,-130,"14,15"
3870,55,"2,5",Luzern,6102,1310,886,-424,-170,"16,1"
3871,60,3,Genf,1227,1915,1110,-805,-268,"18,5"
3872,80,"3,5",Waadt,1373,1640,1320,-320,-91,"16,5"
3873,73,"2,5",Luzern,6143,1020,1175,155,62,"16,1"
3875,60,3,Aargau,5722,1200,906,-294,-98,"15,1"
3876,22,1,Bern,3044,1100,352,-748,-748,16
3877,96,"4,5",St. Gallen,9443,1550,1253,-297,-66,"13,05"
3882,100,"4,5",Bern,3422,1660,1385,-275,-61,"13,85"
3887,20,1,Zürich,8004,1300,436,-864,-864,"21,8"
3888,100,"4,5",Zürich,8915,2014,1755,-259,-58,"17,55"
3890,160,3,Bern,3645,2200,2320,120,40,"14,5"
3892,70,"3,5",Aargau,5103,1400,1029,-371,-106,"14,7"
3893,101,4,Bern,3703,1800,1424,-376,-94,"14,1"
3895,110,4,Freiburg,1756,1880,1485,-395,-99,"13,5"
3896,83,3,St. Gallen,8863,1440,1195,-245,-82,"14,4"
3896,83,3,Schwyz,8863,1440,1353,-87,-29,"16,3"
3897,75,2,Basel-Stadt,4057,1850,1365,-485,-243,"18,2"
3898,190,6,Bern,3413,1950,2565,615,103,"13,5"
3899,94,"3,5",Wallis,1908,1300,1246,-54,-15,"13,25"
3900,75,2,Basel-Stadt,4057,1850,1365,-485,-243,"18,2"
3901,40,1,Waadt,1142,1350,852,-498,-498,"21,3"
3902,92,"3,5",Zürich,8953,2790,1665,-1125,-321,"18,1"
3902,92,"3,5",Aargau,8953,2790,1352,-1438,-411,"14,7"
3903,67,"3,5",Basel-Landschaft,4104,1600,1102,-498,-142,"16,45"
3904,110,"3,5",Aargau,5400,2590,1617,-973,-278,"14,7"
3905,151,"4,5",Nidwalden,6370,3200,2265,-935,-208,15
3906,75,3,Waadt,1092,2500,1283,-1217,-406,"17,1"
3907,75,3,Basel-Stadt,4057,1850,1260,-590,-197,"16,8"
3908,106,"4,5",Nidwalden,6370,2870,1590,-1280,-284,15
3909,116,"4,5",Nidwalden,6370,2970,1740,-1230,-273,15
3910,40,1,Basel-Stadt,4057,1400,700,-700,-700,"17,5"
3911,81,"3,5",Schwyz,8854,2063,1308,-755,-216,"16,15"
3912,80,"3,5",Zürich,8810,1980,1448,-532,-152,"18,1"
3913,110,"4,5",Waadt,1607,1870,1793,-77,-17,"16,3"
3914,75,"3,5",Schwyz,8842,1200,1211,11,3,"16,15"
3915,140,2,Bern,2514,1550,2128,578,289,"15,2"
3916,100,"3,5",St. Gallen,9014,1450,1385,-65,-19,"13,85"
3916,100,"3,5",Appenzell Ausserrhoden,9014,1450,1275,-175,-50,"12,75"
3917,75,3,Basel-Stadt,4057,1850,1260,-590,-197,"16,8"
3918,40,1,Basel-Stadt,4057,1400,700,-700,-700,"17,5"
3920,100,"4,5",Waadt,1807,2700,1630,-1070,-238,"16,3"
3921,70,"3,5",Nidwalden,6370,1250,1113,-137,-39,"15,9"
3923,120,"4,5",Freiburg,1673,1750,1620,-130,-29,"13,5"
3924,170,"5,5",Zürich,8712,3400,3035,-365,-66,"17,85"
3925,83,"5,5",Zürich,8632,1870,1482,-388,-71,"17,85"
3927,75,"2,5",Basel-Stadt,4057,1850,1313,-537,-215,"17,5"
3928,240,5,Tessin,6745,1500,3408,1908,382,"14,2"
3929,56,2,Schwyz,8832,1861,997,-864,-432,"17,8"
3930,100,"4,5",Luzern,6210,1860,1415,-445,-99,"14,15"
3931,60,"2,5",Luzern,6004,1790,966,-824,-330,"16,1"
3932,95,"4,5",Bern,3362,1470,1316,-154,-34,"13,85"
3933,109,"4,5",Aargau,5612,1800,1553,-247,-55,"14,25"
3935,38,2,Waadt,1800,1100,695,-405,-203,"18,3"
3936,54,"2,5",Wallis,1870,960,778,-182,-73,"14,4"
3937,41,"1,5",Wallis,1870,790,662,-128,-85,"16,15"
3938,64,"2,5",Wallis,1870,1080,922,-158,-63,"14,4"
3939,90,"3,5",Tessin,6986,1300,1215,-85,-24,"13,5"
3940,71,"3,5",Tessin,6922,1170,959,-211,-60,"13,5"
3941,102,"4,5",Luzern,6043,1680,1443,-237,-53,"14,15"
3942,160,"3,5",Zürich,8307,2000,2896,896,256,"18,1"
3943,89,"3,5",Aargau,5706,1390,1308,-82,-23,"14,7"
3944,115,"5,5",Bern,3800,2040,1558,-482,-88,"13,55"
3945,71,"3,5",St. Gallen,9470,1420,983,-437,-125,"13,85"
3946,89,"4,5",Bern,3550,1460,1233,-227,-50,"13,85"
3947,65,"3,5",Zürich,8302,1590,1177,-413,-118,"18,1"
3951,60,"2,5",Aargau,5600,1590,933,-657,-263,"15,55"
3953,96,"4,5",Zürich,8105,1700,1685,-15,-3,"17,55"
3957,72,"3,5",Waadt,1110,2430,1188,-1242,-355,"16,5"
3958,49,"2,5",Waadt,1110,1820,867,-953,-381,"17,7"
3959,37,2,Waadt,1012,1200,677,-523,-262,"18,3"
3960,25,1,Graubünden,7250,740,468,-272,-272,"18,7"
3961,80,"3,5",Tessin,6855,1600,1080,-520,-149,"13,5"
3962,57,"2,5",Tessin,6900,1200,761,-439,-176,"13,35"
3966,90,"4,5",Waadt,1343,1990,1467,-523,-116,"16,3"
3967,50,2,Freiburg,1700,1125,785,-340,-170,"15,7"
3968,43,"2,5",Waadt,1260,1710,761,-949,-380,"17,7"
3973,150,"4,5",Tessin,6900,2500,2078,-422,-94,"13,85"
3975,71,"3,5",Schwyz,8730,1438,1147,-291,-83,"16,15"
3975,71,"3,5",St. Gallen,8730,1438,983,-455,-130,"13,85"
3976,78,"3,5",Waadt,1303,1990,1287,-703,-201,"16,5"
3980,263,6,Zug,6333,6700,5918,-782,-130,"22,5"
3985,142,"4,5",Zürich,8001,6950,2492,-4458,-991,"17,55"
3987,100,"3,5",Zürich,8005,3975,1810,-2165,-619,"18,1"
3988,66,"5,5",Bern,4912,2800,894,-1906,-347,"13,55"
3990,196,"5,5",Luzern,6232,4400,2773,-1627,-296,"14,15"
3991,250,"5,5",Basel-Landschaft,4450,4900,4400,-500,-91,"17,6"
3994,120,6,Basel-Stadt,4125,3100,2292,-808,-135,"19,1"
3996,90,4,Genf,1202,3135,1629,-1506,-377,"18,1"
3997,90,"3,5",Tessin,6673,1500,1215,-285,-81,"13,5"
3998,62,"3,5",Jura,2900,1050,701,-349,-100,"11,3"
3999,160,"4,5",Thurgau,8266,3600,1976,-1624,-361,"12,35"
4000,125,"5,5",Tessin,6944,2350,1888,-462,-84,"15,1"
4001,60,"2,5",Tessin,6500,1200,801,-399,-160,"13,35"
4002,115,"3,5",Wallis,3930,1350,1524,174,50,"13,25"
4005,96,"3,5",Aargau,5070,2120,1411,-709,-203,"14,7"
4006,84,"3,5",Zürich,8135,1650,1520,-130,-37,"18,1"
4007,38,"1,5",Basel-Landschaft,4052,1625,648,-977,-651,"17,05"
4007,38,"1,5",Basel-Stadt,4052,1625,678,-947,-631,"17,85"
4009,124,5,Waadt,1010,2380,2071,-309,-62,"16,7"
4010,97,"4,5",Waadt,1196,2255,1581,-674,-150,"16,3"
4011,97,"3,5",St. Gallen,9000,2070,1343,-727,-208,"13,85"
4012,89,"3,5",Aargau,5608,1730,1308,-422,-121,"14,7"
4013,97,"3,5",Zürich,8712,2215,1756,-459,-131,"18,1"
4014,56,2,Luzern,6004,1690,941,-749,-375,"16,8"
4015,23,1,Zürich,8045,990,501,-489,-489,"21,8"
4016,83,"3,5",Bern,3067,1590,1187,-403,-115,"14,3"
4017,54,2,Bern,3018,1140,821,-319,-160,"15,2"
4019,66,3,Bern,2502,1376,957,-419,-140,"14,5"
4020,103,3,Waadt,1260,2630,1761,-869,-290,"17,1"
4021,131,"5,5",Bern,3008,2965,1775,-1190,-216,"13,55"
4022,86,4,St. Gallen,9000,1470,1144,-326,-82,"13,3"
4023,108,"4,5",Solothurn,4600,1675,1393,-282,-63,"12,9"
4023,108,"4,5",Aargau,4600,1675,1539,-136,-30,"14,25"
4025,63,3,Aargau,5430,1420,951,-469,-156,"15,1"
4026,75,3,Basel-Stadt,4056,2035,1260,-775,-258,"16,8"
4027,40,2,Bern,3008,1220,608,-612,-306,"15,2"
4029,56,"2,5",Waadt,1023,1365,991,-374,-150,"17,7"
4030,84,"3,5",Basel-Landschaft,4410,1460,1382,-78,-22,"16,45"
4031,31,1,Tessin,6900,840,363,-477,-477,"11,7"
4032,38,"1,5",Zürich,8006,1210,808,-402,-268,"21,25"
4035,62,3,Waadt,1350,1485,1060,-425,-142,"17,1"
4036,73,"3,5",Bern,3073,1670,1044,-626,-179,"14,3"
4038,21,1,Waadt,1008,835,447,-388,-388,"21,3"
4039,53,"2,5",Schaffhausen,8200,1495,761,-734,-294,"14,35"
4040,61,3,Thurgau,8500,1200,848,-352,-117,"13,9"
4040,61,3,Zürich,8500,1200,1141,-59,-20,"18,7"
4041,70,3,Zürich,8604,1485,1309,-176,-59,"18,7"
4047,144,"5,5",Luzern,6221,1925,2038,113,21,"14,15"
4048,87,4,Basel-Landschaft,4127,1915,1409,-506,-127,"16,2"
4050,18,"1,5",Aargau,5000,990,291,-699,-466,"16,15"
4051,16,1,Waadt,1020,1135,341,-794,-794,"21,3"
4054,77,"3,5",Zürich,8038,2300,1394,-906,-259,"18,1"
4055,85,"3,5",Zürich,8152,1925,1539,-386,-110,"18,1"
4057,79,3,Aargau,5417,1570,1193,-377,-126,"15,1"
4058,62,"3,5",Genf,1208,2200,1135,-1065,-304,"18,3"
4059,60,"3,5",Genf,1205,2490,1098,-1392,-398,"18,3"
4060,67,"3,5",Solothurn,4500,1150,888,-262,-75,"13,25"
4061,72,"3,5",Waadt,1012,2350,1188,-1162,-332,"16,5"
4062,95,"3,5",Waadt,1025,2790,1568,-1222,-349,"16,5"
4063,77,"3,5",Waadt,1562,1610,1271,-339,-97,"16,5"
4063,77,"3,5",Freiburg,1562,1610,1090,-520,-149,"14,15"
4064,77,"3,5",Waadt,1562,1510,1271,-239,-68,"16,5"
4064,77,"3,5",Freiburg,1562,1510,1090,-420,-120,"14,15"
4065,68,"3,5",Freiburg,1470,1430,962,-468,-134,"14,15"
4066,60,"3,5",Waadt,1522,1400,990,-410,-117,"16,5"
4067,160,"5,5",Tessin,6934,2900,2416,-484,-88,"15,1"
4068,73,"3,5",Waadt,1462,1730,1205,-525,-150,"16,5"
4069,59,"2,5",Waadt,1004,1750,1044,-706,-282,"17,7"
4070,95,"4,5",Aargau,4856,1500,1354,-146,-32,"14,25"
4072,74,"3,5",Freiburg,1670,1650,1047,-603,-172,"14,15"
4075,323,6,Genf,1293,7500,7300,-200,-33,"22,6"
4076,53,3,Zürich,8102,1890,991,-899,-300,"18,7"
4077,81,4,Zürich,8707,2600,1418,-1182,-296,"17,5"
4082,50,2,Zürich,8126,1399,1035,-364,-182,"20,7"
4085,100,"4,5",Luzern,6020,1660,1415,-245,-54,"14,15"
4086,70,"3,5",Solothurn,4500,1310,928,-382,-109,"13,25"
4087,67,3,Basel-Landschaft,4153,1210,1119,-91,-30,"16,7"
4090,55,"3,5",Waadt,1018,1930,908,-1022,-292,"16,5"
4095,75,"3,5",Wallis,3960,1470,994,-476,-136,"13,25"
4096,76,"3,5",Wallis,3960,1780,1007,-773,-221,"13,25"
4097,55,"2,5",Wallis,3960,1200,792,-408,-163,"14,4"
4098,95,"4,5",Wallis,3960,1770,1207,-563,-125,"12,7"
4099,60,"2,5",Wallis,3960,1550,864,-686,-274,"14,4"
4101,75,3,St. Gallen,9000,1200,1080,-120,-40,"14,4"
4103,95,1,Zürich,8330,1710,2071,361,361,"21,8"
4107,70,4,Aargau,5452,1495,1001,-494,-124,"14,3"
4108,90,"3,5",Solothurn,4616,1380,1193,-187,-53,"13,25"
4109,116,"5,5",Zürich,8932,2490,2071,-419,-76,"17,85"
4110,84,4,Zürich,8304,1955,1470,-485,-121,"17,5"
4111,70,2,Graubünden,7430,995,1148,153,77,"16,4"
4112,75,"3,5",Aargau,5507,1505,1103,-402,-115,"14,7"
4113,78,4,Luzern,6247,1420,1108,-312,-78,"14,2"
4115,160,"5,5",Aargau,5504,2390,2264,-126,-23,"14,15"
4116,124,5,Aargau,5600,2340,1761,-579,-116,"14,2"
4119,88,"3,5",Bern,3018,1765,1258,-507,-145,"14,3"
4120,100,"3,5",Zürich,8052,1985,1810,-175,-50,"18,1"
4122,220,"4,5",St. Gallen,9470,2430,2871,441,98,"13,05"
4123,92,3,Basel-Stadt,4059,2050,1546,-504,-168,"16,8"
4124,191,4,Obwalden,6010,2290,2598,308,77,"13,6"
4124,191,4,Nidwalden,6010,2290,2884,594,149,"15,1"
4124,191,4,Luzern,6010,2290,2712,422,106,"14,2"
4126,85,3,Luzern,6005,2480,1309,-1171,-390,"15,4"
4127,121,"3,5",Zürich,8180,2980,2190,-790,-226,"18,1"
4128,129,"4,5",Zürich,8180,2940,2264,-676,-150,"17,55"
4129,119,"4,5",Zürich,8180,3125,2088,-1037,-230,"17,55"
4130,122,"4,5",Zürich,8180,2985,2141,-844,-188,"17,55"
4133,85,"3,5",Tessin,6900,1900,1148,-752,-215,"13,5"
4135,65,3,Zürich,8706,1980,1216,-764,-255,"18,7"
4136,85,"4,5",Glarus,8868,1320,1029,-291,-65,"12,1"
4137,50,"2,5",Bern,3270,1290,743,-547,-219,"14,85"
4138,40,"1,5",Zürich,8820,1450,850,-600,-400,"21,25"
4147,86,"3,5",Freiburg,1782,1670,1217,-453,-129,"14,15"
4149,104,"4,5",Aargau,5605,1908,1482,-426,-95,"14,25"
4150,105,"4,5",Aargau,5728,1785,1496,-289,-64,"14,25"
4151,89,"3,5",Aargau,5605,1755,1308,-447,-128,"14,7"
4152,85,"3,5",Aargau,5728,1520,1250,-270,-77,"14,7"
4153,87,"3,5",Luzern,6030,1790,1288,-502,-143,"14,8"
4156,165,"5,5",Zug,6340,6650,3399,-3251,-591,"20,6"
4157,84,"3,5",Aargau,5200,1890,1235,-655,-187,"14,7"
4158,56,"2,5",Aargau,5200,1450,871,-579,-232,"15,55"
4159,26,"1,5",Aargau,5200,920,420,-500,-333,"16,15"
4165,47,2,St. Gallen,9000,1050,724,-326,-163,"15,4"
4169,81,4,Luzern,6006,1690,1150,-540,-135,"14,2"
4170,64,"3,5",Tessin,6912,1000,864,-136,-39,"13,5"
4173,55,"2,5",Tessin,6900,1850,734,-1116,-446,"13,35"
4176,147,"5,5",Zürich,8633,2790,2624,-166,-30,"17,85"
4176,147,"5,5",St. Gallen,8633,2790,1845,-945,-172,"12,55"
4177,88,"3,5",Tessin,6900,2100,1188,-912,-261,"13,5"
4179,127,"4,5",Zürich,8246,2045,2229,184,41,"17,55"
4180,140,6,Zürich,8630,2300,2534,234,39,"18,1"
4180,140,6,St. Gallen,8630,2300,1722,-578,-96,"12,3"
4182,63,"2,5",Zürich,8008,2200,1241,-959,-384,"19,7"
4183,100,4,Basel-Stadt,4056,1820,1670,-150,-38,"16,7"
4184,83,4,Aargau,5070,1391,1187,-204,-51,"14,3"
4185,110,"4,5",Appenzell Ausserrhoden,9425,2190,1348,-842,-187,"12,25"
4185,110,"4,5",St. Gallen,9425,2190,1436,-754,-168,"13,05"
4186,110,"4,5",Appenzell Ausserrhoden,9425,2090,1348,-742,-165,"12,25"
4186,110,"4,5",St. Gallen,9425,2090,1436,-654,-145,"13,05"
4187,84,"3,5",Appenzell Ausserrhoden,9425,1695,1071,-624,-178,"12,75"
4187,84,"3,5",St. Gallen,9425,1695,1163,-532,-152,"13,85"
4188,84,"3,5",Appenzell Ausserrhoden,9425,1695,1071,-624,-178,"12,75"
4188,84,"3,5",St. Gallen,9425,1695,1163,-532,-152,"13,85"
4189,60,"2,5",Appenzell Ausserrhoden,9425,1545,834,-711,-284,"13,9"
4189,60,"2,5",St. Gallen,9425,1545,894,-651,-260,"14,9"
4190,65,"2,5",Appenzell Ausserrhoden,9425,1395,904,-491,-196,"13,9"
4190,65,"2,5",St. Gallen,9425,1395,969,-426,-170,"14,9"
4191,123,"4,5",Tessin,6600,1850,1704,-146,-32,"13,85"
4193,90,"3,5",Aargau,4313,1387,1323,-64,-18,"14,7"
4194,92,4,Basel-Stadt,4059,2240,1536,-704,-176,"16,7"
4199,92,"3,5",Zürich,8600,2400,1665,-735,-210,"18,1"
4201,56,"2,5",Tessin,6600,1350,748,-602,-241,"13,35"
4202,110,"3,5",Zürich,8804,2680,1991,-689,-197,"18,1"
4203,58,2,Zürich,8136,1650,1201,-449,-225,"20,7"
4204,60,"2,5",Basel-Stadt,4054,1380,1050,-330,-132,"17,5"
4208,68,"2,5",Aargau,5043,1430,1057,-373,-149,"15,55"
4209,400,"5,5",Basel-Landschaft,4415,2500,7040,4540,825,"17,6"
4212,74,3,Bern,3027,1410,1073,-337,-112,"14,5"
4213,79,"3,5",Freiburg,3280,1610,1118,-492,-141,"14,15"
4214,70,"2,5",Bern,3303,1390,1040,-350,-140,"14,85"
4215,90,"3,5",St. Gallen,9463,1590,1247,-343,-98,"13,85"
4216,102,"4,5",St. Gallen,9463,1740,1331,-409,-91,"13,05"
4217,82,"3,5",Basel-Landschaft,4242,1890,1349,-541,-155,"16,45"
4218,160,"3,5",Schaffhausen,8222,1600,2104,504,144,"13,15"
4221,100,"3,5",Bern,3074,2320,1430,-890,-254,"14,3"
4222,28,1,Schwyz,8834,1500,501,-999,-999,"17,9"
4223,121,"4,5",Luzern,6004,3940,1712,-2228,-495,"14,15"
4224,49,"1,5",Aargau,5610,930,791,-139,-93,"16,15"
4227,170,"3,5",Zürich,8610,3200,3077,-123,-35,"18,1"
4230,17,1,Luzern,6015,820,320,-500,-500,"18,8"
4231,75,"3,5",Aargau,8957,1650,1103,-547,-156,"14,7"
4232,70,3,Zürich,8002,1670,1309,-361,-120,"18,7"
4233,85,4,Nidwalden,6374,1590,1284,-306,-77,"15,1"
4234,90,4,Tessin,6648,2500,1215,-1285,-321,"13,5"
4235,75,3,Tessin,6648,2000,1013,-987,-329,"13,5"
4236,90,4,Tessin,6648,800,1215,415,104,"13,5"
4237,40,"1,5",Luzern,6020,920,712,-208,-139,"17,8"
4238,100,"4,5",Zug,6300,3430,1875,-1555,-346,"18,75"
4239,75,3,Tessin,6648,600,1013,413,138,"13,5"
4240,77,4,Tessin,6900,1605,1040,-565,-141,"13,5"
4241,55,2,Zug,6330,884,1194,310,155,"21,7"
4243,66,3,Zürich,8483,1250,1234,-16,-5,"18,7"
4244,15,1,Luzern,6015,750,282,-468,-468,"18,8"
4246,98,"3,5",Zürich,8805,2300,1774,-526,-150,"18,1"
4247,75,4,Appenzell Ausserrhoden,9104,1190,953,-237,-59,"12,7"
4248,15,1,Luzern,6015,780,282,-498,-498,"18,8"
4249,150,"4,5",Aargau,5620,2420,2138,-282,-63,"14,25"
4252,119,"4,5",Bern,3123,2280,1648,-632,-140,"13,85"
4254,56,"2,5",Aargau,8918,1495,871,-624,-250,"15,55"
4255,90,"3,5",Zürich,8157,1800,1629,-171,-49,"18,1"
4256,123,"5,5",Waadt,1006,4150,2091,-2059,-374,17
4257,66,3,Basel-Landschaft,4132,1490,1102,-388,-129,"16,7"
4259,70,"2,5",Aargau,5642,1820,1089,-731,-292,"15,55"
4259,70,"2,5",Zug,5642,1820,1442,-378,-151,"20,6"
4261,80,4,Zürich,8604,1528,1400,-128,-32,"17,5"
4262,53,"2,5",Zürich,8610,1501,1044,-457,-183,"19,7"
4263,80,"3,5",Zürich,8620,2134,1448,-686,-196,"18,1"
4264,57,2,St. Gallen,9016,1045,878,-167,-84,"15,4"
4265,82,"2,5",Zürich,8404,1630,1615,-15,-6,"19,7"
4267,97,"3,5",Waadt,1585,1495,1601,106,30,"16,5"
4268,89,"3,5",Freiburg,1630,1990,1259,-731,-209,"14,15"
4269,91,"3,5",Zürich,8193,1900,1647,-253,-72,"18,1"
4270,90,"3,5",Zürich,8002,3950,1629,-2321,-663,"18,1"
4271,82,4,Thurgau,8505,1320,1050,-270,-68,"12,8"
4272,85,"3,5",Aargau,5024,1760,1250,-510,-146,"14,7"
4273,70,"2,5",Zürich,8303,1650,1379,-271,-108,"19,7"
4275,94,"3,5",Zürich,8193,1880,1701,-179,-51,"18,1"
4276,49,2,Aargau,5432,1180,784,-396,-198,16
4277,114,"4,5",Zürich,8142,3990,2001,-1989,-442,"17,55"
4278,100,"5,5",Aargau,5330,1595,1415,-180,-33,"14,15"
4280,44,2,Waadt,1024,1190,805,-385,-193,"18,3"
4281,90,3,Waadt,1022,2460,1539,-921,-307,"17,1"
4283,60,3,Genf,1227,1915,1110,-805,-268,"18,5"
4285,130,"4,5",Aargau,4805,1920,1853,-67,-15,"14,25"
4286,144,"5,5",Aargau,5608,2240,2038,-202,-37,"14,15"
4288,105,"3,5",Luzern,6248,1695,1554,-141,-40,"14,8"
4290,18,1,St. Gallen,9000,695,286,-409,-409,"15,9"
4292,65,"2,5",Zürich,8610,1680,1281,-399,-160,"19,7"
4295,90,"3,5",Zürich,8610,1980,1629,-351,-100,"18,1"
4298,100,"4,5",Luzern,6246,1500,1415,-85,-19,"14,15"
4301,72,3,Appenzell Ausserrhoden,9053,900,922,22,7,"12,8"
4301,72,3,Appenzell Innerrhoden,9053,900,1080,180,60,15
4302,42,"1,5",Luzern,6020,1100,748,-352,-235,"17,8"
4304,128,"4,5",Luzern,6248,1970,1811,-159,-35,"14,15"
4307,98,"3,5",Schwyz,6438,1950,1583,-367,-105,"16,15"
4311,109,"4,5",Zürich,8053,3435,1913,-1522,-338,"17,55"
4313,80,"3,5",Waadt,1373,1640,1320,-320,-91,"16,5"
4314,70,4,Zürich,8600,1710,1225,-485,-121,"17,5"
4316,78,"3,5",Schwyz,8832,1815,1260,-555,-159,"16,15"
4318,85,"3,5",St. Gallen,9242,1775,1177,-598,-171,"13,85"
4319,63,"2,5",St. Gallen,9242,1425,939,-486,-194,"14,9"
4321,106,"4,5",Thurgau,8570,1892,1309,-583,-130,"12,35"
4323,63,3,Zürich,8404,1510,1178,-332,-111,"18,7"
4328,80,"3,5",Schwyz,6442,1400,1292,-108,-31,"16,15"
4329,20,2,Zürich,8004,1850,414,-1436,-718,"20,7"
4331,24,1,St. Gallen,9000,650,382,-268,-268,"15,9"
4332,79,"2,5",Basel-Landschaft,4132,1457,1335,-122,-49,"16,9"
4333,30,1,Graubünden,7000,750,561,-189,-189,"18,7"
4335,142,"4,5",Appenzell Innerrhoden,9056,2150,1818,-332,-74,"12,8"
4335,142,"4,5",Appenzell Ausserrhoden,9056,2150,1740,-410,-91,"12,25"
4336,110,"3,5",St. Gallen,8887,1700,1524,-176,-50,"13,85"
4337,130,"4,5",Luzern,6005,2800,1839,-961,-214,"14,15"
4338,63,"2,5",Zürich,8460,871,1241,370,148,"19,7"
4339,85,"3,5",Luzern,6017,1630,1258,-372,-106,"14,8"
4340,85,"3,5",Luzern,6017,1730,1258,-472,-135,"14,8"
4341,79,"3,5",Zürich,8400,1760,1430,-330,-94,"18,1"
4344,106,"4,5",Graubünden,7012,1920,1431,-489,-109,"13,5"
4345,180,"5,5",Thurgau,8586,2400,2133,-267,-49,"11,85"
4347,46,2,Solothurn,4500,970,639,-331,-166,"13,9"
4348,139,"5,5",Uri,6460,2270,1779,-491,-89,"12,8"
4349,50,"2,5",Basel-Landschaft,4142,1200,845,-355,-142,"16,9"
4351,98,"3,5",Zürich,8603,2150,1774,-376,-107,"18,1"
4353,34,2,Glarus,8755,820,517,-303,-152,"15,2"
4354,65,"2,5",Tessin,6921,1420,868,-552,-221,"13,35"
4355,149,4,Zug,6300,5050,2801,-2249,-562,"18,8"
4357,35,"1,5",Basel-Stadt,4058,3000,625,-2375,-1583,"17,85"
4359,140,"4,5",Luzern,6207,2530,1981,-549,-122,"14,15"
4361,80,4,Appenzell Ausserrhoden,9410,1240,1016,-224,-56,"12,7"
4364,120,"4,5",Luzern,6023,2350,1698,-652,-145,"14,15"
4370,160,"5,5",Luzern,6102,2050,2264,214,39,"14,15"
4371,130,"4,5",Appenzell Innerrhoden,9450,1600,1664,64,14,"12,8"
4371,130,"4,5",Appenzell Ausserrhoden,9450,1600,1593,-7,-2,"12,25"
4371,130,"4,5",St. Gallen,9450,1600,1697,97,22,"13,05"
4372,70,"2,5",Thurgau,8500,1238,991,-247,-99,"14,15"
4372,70,"2,5",Zürich,8500,1238,1379,141,56,"19,7"
4373,219,"5,5",St. Gallen,9470,2280,2748,468,85,"12,55"
4374,35,1,St. Gallen,7320,630,557,-73,-73,"15,9"
4376,80,"3,5",Obwalden,6010,1890,1104,-786,-225,"13,8"
4376,80,"3,5",Nidwalden,6010,1890,1272,-618,-177,"15,9"
4376,80,"3,5",Luzern,6010,1890,1184,-706,-202,"14,8"
4378,120,5,Zürich,8932,2400,2112,-288,-58,"17,6"
4382,44,2,Basel-Stadt,4056,1050,801,-249,-125,"18,2"
4383,46,2,Solothurn,4500,970,639,-331,-166,"13,9"
4385,85,"2,5",St. Gallen,9000,1490,1267,-223,-89,"14,9"
4387,120,"4,5",Luzern,6213,1290,1698,408,91,"14,15"
4388,70,"3,5",Bern,3309,1190,1001,-189,-54,"14,3"
4389,76,"3,5",Thurgau,8280,1400,1015,-385,-110,"13,35"
4390,119,"4,5",Basel-Landschaft,4242,2334,1964,-370,-82,"16,5"
4391,150,"5,5",Bern,3065,2500,2033,-467,-85,"13,55"
4392,80,"3,5",Thurgau,8580,1050,1068,18,5,"13,35"
4392,80,"3,5",St. Gallen,8580,1050,1108,58,17,"13,85"
4397,100,"4,5",Luzern,6210,1590,1415,-175,-39,"14,15"
4398,65,"3,5",St. Gallen,9478,1150,900,-250,-71,"13,85"
4400,13,1,Schwyz,6440,430,233,-197,-197,"17,9"
4403,130,"4,5",Schwyz,8840,2300,2035,-265,-59,"15,65"
4404,72,4,Thurgau,8570,1630,922,-708,-177,"12,8"
4405,90,4,Schwyz,6432,1590,1440,-150,-38,16
4410,22,1,St. Gallen,7310,620,350,-270,-270,"15,9"
4413,109,"4,5",Schwyz,6415,1970,1706,-264,-59,"15,65"
4416,48,2,Waadt,1022,1509,878,-631,-316,"18,3"
4419,22,1,Waadt,1030,1563,469,-1094,-1094,"21,3"
4420,115,"4,5",Tessin,6900,2950,1593,-1357,-302,"13,85"
4421,70,"2,5",Zürich,8008,3150,1379,-1771,-708,"19,7"
4422,80,"2,5",Zürich,8008,3250,1576,-1674,-670,"19,7"
4423,81,"3,5",Wallis,1950,1360,1073,-287,-82,"13,25"
4424,106,"4,5",Basel-Stadt,4125,2590,1802,-788,-175,17
4425,67,"2,5",Zürich,8152,2190,1320,-870,-348,"19,7"
4426,92,"3,5",Thurgau,8357,1430,1228,-202,-58,"13,35"
4427,106,"3,5",St. Gallen,9008,1490,1468,-22,-6,"13,85"
4428,100,"4,5",Luzern,6232,1650,1415,-235,-52,"14,15"
4429,90,4,Genf,1204,3780,1629,-2151,-538,"18,1"
4430,127,"5,5",Zürich,8155,2300,2267,-33,-6,"17,85"
4431,72,"3,5",Zürich,8804,1660,1303,-357,-102,"18,1"
4433,92,3,Freiburg,1700,1700,1362,-338,-113,"14,8"
4435,85,"3,5",Waadt,1814,2420,1403,-1017,-291,"16,5"
4436,42,2,St. Gallen,8733,1200,647,-553,-277,"15,4"
4441,55,3,Genf,1205,2240,1018,-1222,-407,"18,5"
4442,56,3,Bern,3072,1370,812,-558,-186,"14,5"
4443,114,"4,5",Zürich,8142,3960,2001,-1959,-435,"17,55"
4444,83,"2,5",Waadt,1058,1280,1469,189,76,"17,7"
4446,32,"1,5",St. Gallen,9000,755,501,-254,-169,"15,65"
4447,115,"4,5",Zürich,8103,2915,2018,-897,-199,"17,55"
4448,94,"3,5",Zürich,8408,2101,1701,-400,-114,"18,1"
4449,82,"2,5",Bern,3315,1510,1218,-292,-117,"14,85"
4450,68,3,Basel-Landschaft,4052,1350,1136,-214,-71,"16,7"
4450,68,3,Basel-Stadt,4052,1350,1142,-208,-69,"16,8"
4451,56,"2,5",Freiburg,1630,1430,854,-576,-230,"15,25"
4452,71,"2,5",Freiburg,1630,1420,1083,-337,-135,"15,25"
4453,83,"3,5",Freiburg,1630,1610,1174,-436,-125,"14,15"
4454,15,1,Jura,2852,590,177,-413,-413,"11,8"
4455,107,"3,5",Basel-Stadt,4057,2220,1792,-428,-122,"16,75"
4456,52,"2,5",St. Gallen,9403,1390,775,-615,-246,"14,9"
4458,61,3,Basel-Landschaft,4142,1450,1019,-431,-144,"16,7"
4461,54,"2,5",Aargau,5000,1880,840,-1040,-416,"15,55"
4462,46,"1,5",Aargau,5000,1070,743,-327,-218,"16,15"
4463,20,1,Zürich,8152,1200,436,-764,-764,"21,8"
4464,75,"3,5",Aargau,5503,1570,1103,-467,-133,"14,7"
4465,112,"3,5",Zürich,8704,2990,2027,-963,-275,"18,1"
4466,130,"4,5",Tessin,6600,1900,1801,-99,-22,"13,85"
4467,67,"2,5",Aargau,5330,1290,1042,-248,-99,"15,55"
4468,115,"4,5",Zürich,8001,14000,2018,-11982,-2663,"17,55"
4469,92,"4,5",Schaffhausen,8200,1111,1201,90,20,"13,05"
4470,130,"3,5",Aargau,5600,2840,1911,-929,-265,"14,7"
4472,60,"3,5",Schaffhausen,8200,1380,789,-591,-169,"13,15"
4474,70,"2,5",Aargau,5330,1390,1089,-301,-120,"15,55"
4475,42,2,St. Gallen,9000,1190,647,-543,-272,"15,4"
4477,60,"2,5",St. Gallen,9000,950,894,-56,-22,"14,9"
4478,75,"3,5",St. Gallen,9000,1490,1039,-451,-129,"13,85"
4479,173,"5,5",Solothurn,4562,2150,2258,108,20,"13,05"
4480,67,"2,5",Waadt,1009,2760,1186,-1574,-630,"17,7"
4481,162,"5,5",Zug,6331,4280,3337,-943,-171,"20,6"
4482,40,2,Basel-Stadt,4054,956,728,-228,-114,"18,2"
4483,34,"1,5",Luzern,6003,1020,605,-415,-277,"17,8"
4484,160,"3,5",Aargau,5330,1690,2352,662,189,"14,7"
4485,115,"3,5",Aargau,4310,2680,1691,-989,-283,"14,7"
4486,88,"3,5",Aargau,5070,1960,1294,-666,-190,"14,7"
4488,50,"2,5",St. Gallen,9200,1070,745,-325,-130,"14,9"
4489,93,3,Waadt,1660,1810,1590,-220,-73,"17,1"
4490,78,"3,5",Thurgau,8588,990,1041,51,15,"13,35"
4491,106,4,Waadt,1660,2086,1685,-401,-100,"15,9"
4492,84,"3,5",Obwalden,6010,1820,1159,-661,-189,"13,8"
4492,84,"3,5",Nidwalden,6010,1820,1336,-484,-138,"15,9"
4492,84,"3,5",Luzern,6010,1820,1243,-577,-165,"14,8"
4495,111,"3,5",St. Gallen,9533,1720,1537,-183,-52,"13,85"
4496,120,"4,5",Basel-Landschaft,4133,2480,1980,-500,-111,"16,5"
4497,100,"3,5",Zürich,8800,2400,1810,-590,-169,"18,1"
4499,118,"3,5",Basel-Landschaft,4422,1930,1941,11,3,"16,45"
4501,55,"2,5",Wallis,1920,1240,792,-448,-179,"14,4"
4502,98,"3,5",Wallis,1920,1560,1299,-261,-75,"13,25"
4503,100,"4,5",Luzern,6212,2200,1415,-785,-174,"14,15"
4504,100,4,Zürich,8006,2400,1750,-650,-163,"17,5"
4505,83,"3,5",Luzern,6032,1740,1228,-512,-146,"14,8"
4506,100,"2,5",Luzern,6032,1800,1610,-190,-76,"16,1"
4507,110,"4,5",Luzern,6032,2150,1556,-594,-132,"14,15"
4508,45,1,Aargau,4310,1045,734,-311,-311,"16,3"
4509,83,"3,5",Freiburg,1630,1660,1174,-486,-139,"14,15"
4512,26,1,Bern,3007,900,416,-484,-484,16
4513,101,"4,5",Zürich,8197,1600,1773,173,38,"17,55"
4514,68,"3,5",Tessin,6900,1230,918,-312,-89,"13,5"
4517,160,"4,5",Waadt,1196,4500,2608,-1892,-420,"16,3"
4519,79,"2,5",Basel-Landschaft,4132,1457,1335,-122,-49,"16,9"
4520,151,"4,5",Luzern,6242,2880,2137,-743,-165,"14,15"
4523,134,"4,5",Zürich,8245,2400,2352,-48,-11,"17,55"
4524,96,"3,5",Aargau,4310,1960,1411,-549,-157,"14,7"
4525,60,3,Zürich,8152,1680,1122,-558,-186,"18,7"
4527,105,"4,5",Zürich,8630,2350,1843,-507,-113,"17,55"
4527,105,"4,5",St. Gallen,8630,2350,1370,-980,-218,"13,05"
4528,85,"3,5",Thurgau,8500,1450,1135,-315,-90,"13,35"
4528,85,"3,5",Zürich,8500,1450,1539,89,25,"18,1"
4529,64,"2,5",Zürich,8008,3000,1261,-1739,-696,"19,7"
4530,90,"3,5",Zürich,8342,1894,1629,-265,-76,"18,1"
4532,140,"3,5",Waadt,1296,3980,2310,-1670,-477,"16,5"
4533,152,"4,5",St. Gallen,9430,2250,1984,-266,-59,"13,05"
4534,49,2,Basel-Landschaft,4102,1100,838,-262,-131,"17,1"
4537,100,"4,5",Luzern,6210,1590,1415,-175,-39,"14,15"
4539,100,"3,5",Zürich,8050,3400,1810,-1590,-454,"18,1"
4540,46,"2,5",Bern,3075,1190,683,-507,-203,"14,85"
4541,15,1,Bern,3075,280,240,-40,-40,16
4542,140,"5,5",Aargau,5623,1800,1981,181,33,"14,15"
4543,69,"2,5",Zürich,8910,1360,1359,-1,0,"19,7"
4545,86,"3,5",Basel-Landschaft,4142,2030,1415,-615,-176,"16,45"
4546,90,3,Luzern,6210,1590,1386,-204,-68,"15,4"
4547,110,"3,5",Zug,6300,3350,2107,-1243,-355,"19,15"
4548,71,3,Zürich,8055,2023,1328,-695,-232,"18,7"
4552,83,"3,5",Waadt,1800,1580,1370,-210,-60,"16,5"
4553,109,"3,5",Tessin,6930,1980,1472,-508,-145,"13,5"
4556,57,"2,5",St. Gallen,9435,1440,849,-591,-236,"14,9"
4557,116,"3,5",Zug,6343,3500,2221,-1279,-365,"19,15"
4563,90,4,Aargau,5413,1800,1287,-513,-128,"14,3"
4566,80,"3,5",Aargau,5244,1770,1176,-594,-170,"14,7"
4567,60,"2,5",Basel-Stadt,4057,1290,1050,-240,-96,"17,5"
4568,127,"4,5",Zürich,8700,4100,2229,-1871,-416,"17,55"
4569,124,"4,5",Zürich,8008,4700,2176,-2524,-561,"17,55"
4571,80,"2,5",Aargau,5406,1470,1244,-226,-90,"15,55"
4573,86,"3,5",Aargau,5213,1600,1264,-336,-96,"14,7"
4575,85,"3,5",Tessin,6930,1350,1148,-202,-58,"13,5"
4576,101,"3,5",Zürich,8212,1670,1828,158,45,"18,1"
4576,101,"3,5",Schaffhausen,8212,1670,1328,-342,-98,"13,15"
4577,65,4,Zürich,8953,1688,1138,-550,-138,"17,5"
4577,65,4,Aargau,8953,1688,930,-758,-190,"14,3"
4578,81,"2,5",Schwyz,8807,1650,1381,-269,-108,"17,05"
4579,81,"3,5",Zürich,8708,1680,1466,-214,-61,"18,1"
4580,104,"4,5",St. Gallen,9313,750,1357,607,135,"13,05"
4580,104,"4,5",Thurgau,9313,750,1284,534,119,"12,35"
4581,131,"5,5",St. Gallen,9411,1770,1644,-126,-23,"12,55"
4581,131,"5,5",Appenzell Ausserrhoden,9411,1770,1480,-290,-53,"11,3"
4582,62,3,Basel-Landschaft,4133,1350,1035,-315,-105,"16,7"
4583,54,"2,5",Luzern,6006,1790,869,-921,-368,"16,1"
4584,84,4,Obwalden,6010,1630,1142,-488,-122,"13,6"
4584,84,4,Nidwalden,6010,1630,1268,-362,-91,"15,1"
4584,84,4,Luzern,6010,1630,1193,-437,-109,"14,2"
4585,84,"3,5",Obwalden,6010,1820,1159,-661,-189,"13,8"
4585,84,"3,5",Nidwalden,6010,1820,1336,-484,-138,"15,9"
4585,84,"3,5",Luzern,6010,1820,1243,-577,-165,"14,8"
4586,88,"2,5",Obwalden,6060,2295,1258,-1037,-415,"14,3"
4588,91,4,Obwalden,6010,2190,1238,-952,-238,"13,6"
4588,91,4,Nidwalden,6010,2190,1374,-816,-204,"15,1"
4588,91,4,Luzern,6010,2190,1292,-898,-225,"14,2"
4589,50,2,Zürich,8404,1395,1035,-360,-180,"20,7"
4590,145,"4,5",Luzern,6286,1870,2052,182,40,"14,15"
4591,120,"4,5",St. Gallen,9230,1540,1566,26,6,"13,05"
4592,82,"3,5",Waadt,1260,2350,1353,-997,-285,"16,5"
4593,85,"3,5",Waadt,1297,2500,1403,-1097,-313,"16,5"
4594,110,"4,5",Waadt,1607,1830,1793,-37,-8,"16,3"
4595,75,3,Wallis,1950,1250,1043,-207,-69,"13,9"
4596,145,"4,5",Luzern,6286,1870,2052,182,40,"14,15"
4598,120,"4,5",Waadt,1802,3000,1956,-1044,-232,"16,3"
4599,88,"3,5",Zürich,8112,2100,1593,-507,-145,"18,1"
4600,89,"4,5",Zürich,8008,3985,1562,-2423,-538,"17,55"
4601,88,"3,5",Zürich,8008,3910,1593,-2317,-662,"18,1"
4602,125,"5,5",Aargau,5322,1800,1769,-31,-6,"14,15"
4603,190,"5,5",Basel-Landschaft,4414,3100,3344,244,44,"17,6"
4604,112,"4,5",Zürich,8406,2530,1966,-564,-125,"17,55"
4607,22,"1,5",St. Gallen,8887,550,344,-206,-137,"15,65"
4612,125,"4,5",Bern,2503,1860,1731,-129,-29,"13,85"
4615,80,"3,5",St. Gallen,9300,1050,1108,58,17,"13,85"
4616,85,"4,5",St. Gallen,9242,1760,1109,-651,-145,"13,05"
4618,20,"1,5",St. Gallen,8887,550,313,-237,-158,"15,65"
4621,72,3,Bern,3372,1170,1044,-126,-42,"14,5"
4625,95,"3,5",Bern,3800,2080,1359,-721,-206,"14,3"
4627,42,2,Bern,3664,890,638,-252,-126,"15,2"
4628,75,"3,5",Bern,3784,1500,1073,-427,-122,"14,3"
4632,92,"3,5",Freiburg,1680,1650,1302,-348,-99,"14,15"
4634,131,"5,5",St. Gallen,9411,1780,1644,-136,-25,"12,55"
4634,131,"5,5",Appenzell Ausserrhoden,9411,1780,1480,-300,-55,"11,3"
4645,68,"2,5",Zürich,8704,1750,1340,-410,-164,"19,7"
4646,85,3,Zürich,8712,1911,1590,-321,-107,"18,7"
4647,100,3,Zürich,8952,1970,1870,-100,-33,"18,7"
4648,92,"3,5",Solothurn,4552,1350,1219,-131,-37,"13,25"
4649,66,"2,5",Solothurn,4208,1030,908,-122,-49,"13,75"
4650,80,"4,5",Zürich,8050,2575,1404,-1171,-260,"17,55"
4663,76,"3,5",Basel-Landschaft,4148,1370,1250,-120,-34,"16,45"
4665,75,"3,5",Luzern,6222,1500,1110,-390,-111,"14,8"
4668,50,2,Zürich,8404,1395,1035,-360,-180,"20,7"
4669,86,"3,5",Zürich,8400,1675,1557,-118,-34,"18,1"
4670,75,"3,5",Basel-Landschaft,4132,1440,1234,-206,-59,"16,45"
4671,33,1,Zürich,8302,1200,719,-481,-481,"21,8"
4672,64,"2,5",Zürich,8047,2400,1261,-1139,-456,"19,7"
4673,80,"3,5",Zürich,8952,1850,1448,-402,-115,"18,1"
4674,104,"3,5",Luzern,6020,1650,1539,-111,-32,"14,8"
4707,130,"4,5",Luzern,6170,1668,1839,171,38,"14,15"
4710,80,3,Bern,3006,1604,1160,-444,-148,"14,5"
4712,35,"1,5",Zürich,8820,1101,744,-357,-238,"21,25"
4713,28,"1,5",Graubünden,7500,1200,491,-709,-473,"17,55"
4715,72,"3,5",Basel-Landschaft,4414,1412,1184,-228,-65,"16,45"
4716,117,"4,5",Zürich,8406,2503,2053,-450,-100,"17,55"
4717,90,"4,5",Zürich,8400,2540,1580,-960,-213,"17,55"
4718,70,3,Zürich,8152,1815,1309,-506,-169,"18,7"
4720,100,"4,5",Zürich,8608,2050,1755,-295,-66,"17,55"
4722,150,5,Waadt,1182,2960,2505,-455,-91,"16,7"
4723,94,"3,5",Waadt,1042,2100,1551,-549,-157,"16,5"
4725,72,"2,5",Neuchâtel,2043,1320,875,-445,-178,"12,15"
4726,38,1,Neuchâtel,2043,960,452,-508,-508,"11,9"
4729,23,1,Waadt,1007,1580,490,-1090,-1090,"21,3"
4730,150,6,Genf,1222,6200,3390,-2810,-468,"22,6"
4733,86,"4,5",Wallis,1920,1400,1092,-308,-68,"12,7"
4734,84,4,St. Gallen,9000,1270,1117,-153,-38,"13,3"
4736,45,"2,5",Luzern,6004,1510,725,-785,-314,"16,1"
4737,136,"5,5",Luzern,6004,3410,1924,-1486,-270,"14,15"
4738,80,3,Waadt,1260,2000,1368,-632,-211,"17,1"
4739,88,"3,5",Luzern,6252,1570,1302,-268,-77,"14,8"
4740,120,4,Wallis,3973,1450,1512,62,16,"12,6"
4741,207,6,Solothurn,4228,2490,2732,242,40,"13,2"
4742,73,"3,5",St. Gallen,9000,1450,1011,-439,-125,"13,85"
4743,181,4,Jura,2933,850,2045,1195,299,"11,3"
4745,96,"3,5",St. Gallen,8880,1510,1330,-180,-51,"13,85"
4746,56,"2,5",St. Gallen,8887,1150,834,-316,-126,"14,9"
4748,98,"3,5",Nidwalden,6375,2480,1558,-922,-263,"15,9"
4749,50,"2,5",Zürich,8934,1200,985,-215,-86,"19,7"
4750,66,"2,5",Appenzell Innerrhoden,9450,1240,865,-375,-150,"13,1"
4750,66,"2,5",Appenzell Ausserrhoden,9450,1240,917,-323,-129,"13,9"
4750,66,"2,5",St. Gallen,9450,1240,983,-257,-103,"14,9"
4751,75,"2,5",Basel-Landschaft,4441,1350,1268,-82,-33,"16,9"
4752,123,"4,5",Aargau,5053,2170,1753,-417,-93,"14,25"
4753,100,"3,5",Thurgau,8274,1520,1335,-185,-53,"13,35"
4754,76,"3,5",Thurgau,8500,1457,1015,-442,-126,"13,35"
4754,76,"3,5",Zürich,8500,1457,1376,-81,-23,"18,1"
4755,65,"3,5",St. Gallen,9000,1390,900,-490,-140,"13,85"
4756,110,"4,5",Basel-Landschaft,4416,1850,1815,-35,-8,"16,5"
4757,100,"3,5",Graubünden,7240,1200,1505,305,87,"15,05"
4759,60,"2,5",Thurgau,8580,1050,849,-201,-80,"14,15"
4759,60,"2,5",St. Gallen,8580,1050,894,-156,-62,"14,9"
4760,65,"3,5",St. Gallen,9478,1130,900,-230,-66,"13,85"
4761,64,4,Thurgau,9545,1330,819,-511,-128,"12,8"
4762,70,"3,5",St. Gallen,9424,1220,970,-250,-71,"13,85"
4763,150,"4,5",Schwyz,6442,2400,2348,-52,-12,"15,65"
4766,94,"3,5",Wallis,3940,1190,1246,56,16,"13,25"
4771,92,"4,5",Basel-Landschaft,4450,1970,1518,-452,-100,"16,5"
4772,134,"4,5",Appenzell Ausserrhoden,9042,1800,1642,-158,-35,"12,25"
4772,134,"4,5",St. Gallen,9042,1800,1749,-51,-11,"13,05"
4774,96,"4,5",Thurgau,9565,1660,1186,-474,-105,"12,35"
4777,82,"3,5",Wallis,1950,1550,1087,-463,-132,"13,25"
4779,90,"3,5",Thurgau,8370,1750,1202,-548,-157,"13,35"
4780,30,1,Bern,3095,930,480,-450,-450,16
4781,80,4,Thurgau,8585,1100,1024,-76,-19,"12,8"
4782,92,"4,5",Thurgau,8280,1700,1136,-564,-125,"12,35"
4783,70,3,Solothurn,4528,1090,952,-138,-46,"13,6"
4788,80,3,St. Gallen,9466,650,1152,502,167,"14,4"
4789,75,"3,5",Bern,3855,1450,1073,-377,-108,"14,3"
4790,65,"2,5",Bern,3293,750,965,215,86,"14,85"
4791,99,"3,5",Aargau,5623,1850,1455,-395,-113,"14,7"
4792,60,"2,5",Zürich,8523,1019,1182,163,65,"19,7"
4793,116,"4,5",Aargau,5623,2120,1653,-467,-104,"14,25"
4794,80,"3,5",Luzern,6243,1230,1184,-46,-13,"14,8"
4795,220,"4,5",St. Gallen,9470,2430,2871,441,98,"13,05"
4796,64,3,Thurgau,8272,1090,890,-200,-67,"13,9"
4798,68,"2,5",St. Gallen,9436,1200,1013,-187,-75,"14,9"
4801,20,1,Graubünden,7000,780,374,-406,-406,"18,7"
4802,101,"4,5",St. Gallen,9650,2000,1318,-682,-152,"13,05"
4804,57,"2,5",Aargau,5417,1380,886,-494,-198,"15,55"
4805,160,"5,5",Appenzell Ausserrhoden,9042,1950,1808,-142,-26,"11,3"
4805,160,"5,5",St. Gallen,9042,1950,2008,58,11,"12,55"
4806,93,"3,5",St. Gallen,9470,1345,1288,-57,-16,"13,85"
4807,94,"3,5",Bern,3860,1500,1344,-156,-45,"14,3"
4808,65,3,Nidwalden,6374,1680,1086,-594,-198,"16,7"
4811,86,"3,5",Thurgau,9542,1490,1148,-342,-98,"13,35"
4812,152,"4,5",Thurgau,8356,2130,1877,-253,-56,"12,35"
4813,125,"3,5",Thurgau,8266,1290,1669,379,108,"13,35"
4816,95,"3,5",Basel-Landschaft,4144,2950,1563,-1387,-396,"16,45"
4817,92,"4,5",St. Gallen,9468,1450,1201,-249,-55,"13,05"
4818,56,"1,5",Graubünden,7013,900,983,83,55,"17,55"
4822,135,"5,5",Uri,6472,1100,1728,628,114,"12,8"
4824,181,4,Jura,2933,850,2045,1195,299,"11,3"
4826,62,"2,5",Basel-Landschaft,4448,1150,1048,-102,-41,"16,9"
4827,79,"3,5",Graubünden,7000,1740,1189,-551,-157,"15,05"
4828,76,"3,5",Aargau,5034,1720,1117,-603,-172,"14,7"
4831,89,4,Bern,3007,2250,1255,-995,-249,"14,1"
4832,134,"5,5",Bern,2575,1990,1816,-174,-32,"13,55"
4833,93,"3,5",Basel-Stadt,4057,1920,1558,-362,-103,"16,75"
4836,110,"4,5",Basel-Landschaft,4416,2000,1815,-185,-41,"16,5"
4838,91,4,St. Gallen,9602,1201,1210,9,2,"13,3"
4840,74,"2,5",Zürich,8345,1490,1458,-32,-13,"19,7"
4841,119,"4,5",Aargau,8917,2500,1696,-804,-179,"14,25"
4842,104,"3,5",Solothurn,4112,1950,1378,-572,-163,"13,25"
4846,144,"5,5",Basel-Landschaft,4148,2370,2534,164,30,"17,6"
4848,90,4,St. Gallen,9000,1350,1197,-153,-38,"13,3"
4849,72,"2,5",Waadt,1110,2010,1274,-736,-294,"17,7"
4851,120,"4,5",Schwyz,8807,3100,1878,-1222,-272,"15,65"
4852,130,"4,5",Zug,8836,2460,2438,-22,-5,"18,75"
4852,130,"4,5",Schwyz,8836,2460,2035,-425,-94,"15,65"
4853,132,"4,5",Nidwalden,6376,2300,1980,-320,-71,15
4854,144,"4,5",Appenzell Ausserrhoden,9527,2090,1764,-326,-72,"12,25"
4854,144,"4,5",St. Gallen,9527,2090,1879,-211,-47,"13,05"
4855,150,1,Zürich,8620,2600,3270,670,670,"21,8"
4858,50,"2,5",Bern,3098,1250,743,-507,-203,"14,85"
4859,52,"2,5",Bern,3018,1225,772,-453,-181,"14,85"
4861,75,"3,5",Basel-Landschaft,4414,1604,1234,-370,-106,"16,45"
4862,20,"1,5",Bern,3506,620,312,-308,-205,"15,6"
4863,77,"3,5",Zürich,8630,2160,1394,-766,-219,"18,1"
4863,77,"3,5",St. Gallen,8630,2160,1066,-1094,-313,"13,85"
4864,30,"1,5",Tessin,6900,900,374,-526,-351,"12,45"
4865,85,"3,5",Waadt,1297,2500,1403,-1097,-313,"16,5"
4866,109,"3,5",Freiburg,1752,2200,1542,-658,-188,"14,15"
4867,82,"3,5",Zürich,8400,1950,1484,-466,-133,"18,1"
4868,26,1,Waadt,1030,1145,554,-591,-591,"21,3"
4869,83,"3,5",Waadt,1095,2220,1370,-850,-243,"16,5"
4870,92,3,Basel-Stadt,4058,1920,1546,-374,-125,"16,8"
4871,64,"2,5",Solothurn,4528,1370,880,-490,-196,"13,75"
4872,72,"2,5",Bern,3250,1540,1069,-471,-188,"14,85"
4873,97,"3,5",Luzern,6023,2130,1436,-694,-198,"14,8"
4874,70,"3,5",Zürich,8954,1744,1267,-477,-136,"18,1"
4875,62,3,Basel-Landschaft,4123,1400,1035,-365,-122,"16,7"
4878,80,"3,5",Basel-Landschaft,4144,1820,1316,-504,-144,"16,45"
4879,69,"2,5",Aargau,5070,1520,1073,-447,-179,"15,55"
4880,98,"3,5",Bern,3006,2870,1401,-1469,-420,"14,3"
4881,85,"4,5",Basel-Landschaft,4147,1700,1403,-297,-66,"16,5"
4882,76,"3,5",Basel-Landschaft,4142,1810,1250,-560,-160,"16,45"
4884,73,4,Zürich,8404,1550,1278,-272,-68,"17,5"
4885,32,1,Zürich,8406,750,698,-52,-52,"21,8"
4886,76,"3,5",Aargau,4334,1500,1117,-383,-109,"14,7"
4887,37,"1,5",Bern,3400,790,577,-213,-142,"15,6"
4888,54,2,Basel-Stadt,4057,1170,983,-187,-94,"18,2"
4889,25,"1,5",Waadt,1020,1280,495,-785,-523,"19,8"
4890,90,"3,5",Freiburg,1410,1750,1274,-476,-136,"14,15"
4890,90,"3,5",Waadt,1410,1750,1485,-265,-76,"16,5"
4891,78,3,Freiburg,1410,1550,1154,-396,-132,"14,8"
4891,78,3,Waadt,1410,1550,1334,-216,-72,"17,1"
4892,76,3,Freiburg,1410,1550,1125,-425,-142,"14,8"
4892,76,3,Waadt,1410,1550,1300,-250,-83,"17,1"
4893,91,"2,5",Waadt,1820,2560,1611,-949,-380,"17,7"
4895,87,3,Genf,1200,2750,1610,-1140,-380,"18,5"
4896,49,"1,5",Zürich,8037,1700,1041,-659,-439,"21,25"
4897,107,"4,5",Zürich,8603,2050,1878,-172,-38,"17,55"
4898,70,3,Zürich,8706,1865,1309,-556,-185,"18,7"
4899,69,"2,5",Tessin,6600,1510,921,-589,-236,"13,35"
4903,106,"4,5",Waadt,1510,2060,1728,-332,-74,"16,3"
4905,59,3,Freiburg,1700,1320,873,-447,-149,"14,8"
4906,80,3,Waadt,1342,1350,1368,18,6,"17,1"
4907,60,"2,5",Waadt,1342,1400,1062,-338,-135,"17,7"
4908,71,"2,5",Wallis,1957,1220,1022,-198,-79,"14,4"
4910,60,"2,5",Waadt,1562,1200,1062,-138,-55,"17,7"
4910,60,"2,5",Freiburg,1562,1200,915,-285,-114,"15,25"
4911,156,"4,5",Waadt,1442,2100,2543,443,98,"16,3"
4912,82,"3,5",Waadt,1260,2580,1353,-1227,-351,"16,5"
4914,65,"2,5",Tessin,6900,1300,868,-432,-173,"13,35"
4915,111,"4,5",Luzern,6033,2295,1571,-724,-161,"14,15"
4916,92,4,Bern,4900,1590,1297,-293,-73,"14,1"
4917,110,"3,5",Zürich,8152,2590,1991,-599,-171,"18,1"
4919,51,2,Aargau,4800,1190,816,-374,-187,16
4920,109,"4,5",Waadt,1196,2200,1777,-423,-94,"16,3"
4921,109,"5,5",Waadt,1110,2930,1853,-1077,-196,17
4922,110,"4,5",Waadt,1607,1830,1793,-37,-8,"16,3"
4923,118,"4,5",Luzern,6004,2470,1670,-800,-178,"14,15"
4924,32,1,Waadt,1820,950,682,-268,-268,"21,3"
4925,82,"3,5",Waadt,1004,1890,1353,-537,-153,"16,5"
4936,131,4,Freiburg,1723,1375,1769,394,99,"13,5"
4937,65,"3,5",Waadt,1530,1460,1073,-387,-111,"16,5"
4938,79,3,Waadt,1800,1975,1351,-624,-208,"17,1"
4942,82,"3,5",Wallis,3930,1455,1087,-368,-105,"13,25"
4943,135,"5,5",St. Gallen,8636,2295,1694,-601,-109,"12,55"
4943,135,"5,5",Zürich,8636,2295,2410,115,21,"17,85"
4944,31,1,Basel-Landschaft,4053,850,527,-323,-323,17
4944,31,1,Basel-Stadt,4053,850,543,-307,-307,"17,5"
4945,97,"3,5",Tessin,6850,1990,1310,-680,-194,"13,5"
4947,111,"3,5",Waadt,1180,2635,1832,-803,-229,"16,5"
4948,42,2,St. Gallen,9000,920,647,-273,-137,"15,4"
4949,113,5,Zürich,8942,2295,1989,-306,-61,"17,6"
4950,69,3,Zürich,8405,1190,1290,100,33,"18,7"
4951,91,"4,5",Freiburg,1700,1680,1229,-451,-100,"13,5"
4952,85,4,Solothurn,4500,1600,1097,-503,-126,"12,9"
4953,29,"1,5",Genf,1207,1415,558,-857,-571,"19,25"
4954,76,"3,5",Zürich,8307,1460,1376,-84,-24,"18,1"
4955,64,3,Schaffhausen,8200,1330,864,-466,-155,"13,5"
4957,51,"1,5",Zürich,8050,1790,1084,-706,-471,"21,25"
4958,69,3,Zürich,8820,1690,1290,-400,-133,"18,7"
4959,82,"3,5",Waadt,1260,2350,1353,-997,-285,"16,5"
4960,75,3,Wallis,1950,1250,1043,-207,-69,"13,9"
4961,65,"3,5",St. Gallen,9000,1590,900,-690,-197,"13,85"
4962,23,1,Zürich,8052,1090,501,-589,-589,"21,8"
4967,35,"1,5",Basel-Stadt,4058,1120,625,-495,-330,"17,85"
4972,70,3,Waadt,1166,1900,1197,-703,-234,"17,1"
4973,150,"4,5",Waadt,1148,1800,2445,645,143,"16,3"
4974,82,"3,5",Waadt,1510,1675,1353,-322,-92,"16,5"
4975,116,"5,5",Bern,3084,3650,1572,-2078,-378,"13,55"
4980,127,"4,5",Zürich,8400,2805,2229,-576,-128,"17,55"
4982,94,"3,5",Zürich,8105,2675,1701,-974,-278,"18,1"
4983,100,4,Genf,1248,3400,1810,-1590,-398,"18,1"
4984,191,4,Obwalden,6010,2190,2598,408,102,"13,6"
4984,191,4,Nidwalden,6010,2190,2884,694,174,"15,1"
4984,191,4,Luzern,6010,2190,2712,522,131,"14,2"
4985,78,"3,5",Waadt,1562,1460,1287,-173,-49,"16,5"
4985,78,"3,5",Freiburg,1562,1460,1104,-356,-102,"14,15"
4986,50,"2,5",Tessin,6900,1450,668,-782,-313,"13,35"
4987,122,"4,5",Basel-Landschaft,4104,2750,2013,-737,-164,"16,5"
4989,80,4,Basel-Landschaft,4402,2250,1296,-954,-239,"16,2"
4990,71,3,Waadt,1018,1760,1214,-546,-182,"17,1"
4991,51,2,Zug,6300,2280,1107,-1173,-587,"21,7"
4992,57,"2,5",Zürich,8610,1560,1123,-437,-175,"19,7"
4993,85,"3,5",Waadt,1091,2750,1403,-1347,-385,"16,5"
4994,61,3,Basel-Landschaft,4132,1290,1019,-271,-90,"16,7"
4996,88,"2,5",Obwalden,6060,2295,1258,-1037,-415,"14,3"
4997,84,4,Obwalden,6010,1630,1142,-488,-122,"13,6"
4997,84,4,Nidwalden,6010,1630,1268,-362,-91,"15,1"
4997,84,4,Luzern,6010,1630,1193,-437,-109,"14,2"
5001,91,"3,5",Tessin,6834,1150,1229,79,23,"13,5"
5002,80,"3,5",Zürich,8045,2490,1448,-1042,-298,"18,1"
5003,54,3,Zürich,8302,1550,1010,-540,-180,"18,7"
5004,63,2,Zürich,8004,2090,1304,-786,-393,"20,7"
5005,50,2,Zürich,8404,1395,1035,-360,-180,"20,7"
5006,20,1,Graubünden,7430,500,374,-126,-126,"18,7"
5008,85,"3,5",Luzern,6005,2280,1258,-1022,-292,"14,8"
5009,119,"4,5",Luzern,6005,3840,1684,-2156,-479,"14,15"
5010,84,"3,5",Luzern,6005,2680,1243,-1437,-411,"14,8"
5011,95,"3,5",Luzern,6005,2190,1406,-784,-224,"14,8"
5012,36,"1,5",Luzern,6005,1340,641,-699,-466,"17,8"
5013,36,"1,5",Luzern,6005,1540,641,-899,-599,"17,8"
5014,58,"2,5",Luzern,6005,1630,934,-696,-278,"16,1"
5018,140,"4,5",Thurgau,9320,2200,1729,-471,-105,"12,35"
5019,30,1,Zürich,8134,1050,654,-396,-396,"21,8"
5020,72,3,Zürich,8052,1661,1346,-315,-105,"18,7"
5021,60,"2,5",Zürich,8045,1990,1182,-808,-323,"19,7"
5023,61,2,Freiburg,1700,1360,958,-402,-201,"15,7"
5024,66,"3,5",Bern,3303,1430,944,-486,-139,"14,3"
5025,92,"3,5",Waadt,1052,2585,1518,-1067,-305,"16,5"
5026,67,3,Bern,3072,1430,972,-458,-153,"14,5"
5027,28,1,Freiburg,1700,820,510,-310,-310,"18,2"
5028,84,3,Aargau,8965,1638,1268,-370,-123,"15,1"
5030,98,"3,5",Zürich,8953,2390,1774,-616,-176,"18,1"
5030,98,"3,5",Aargau,8953,2390,1441,-949,-271,"14,7"
5031,27,1,Waadt,1004,950,575,-375,-375,"21,3"
5032,116,"5,5",Zürich,8102,3160,2071,-1089,-198,"17,85"
5033,60,"2,5",Basel-Landschaft,4052,1400,1014,-386,-154,"16,9"
5033,60,"2,5",Basel-Stadt,4052,1400,1050,-350,-140,"17,5"
5034,76,3,Freiburg,1700,1590,1125,-465,-155,"14,8"
5040,76,"3,5",Zürich,8427,1490,1376,-114,-33,"18,1"
5041,67,4,Genf,1203,2590,1213,-1377,-344,"18,1"
5043,150,"4,5",Aargau,5430,2930,2138,-792,-176,"14,25"
5044,87,"2,5",Solothurn,4226,1970,1196,-774,-310,"13,75"
5046,127,"3,5",Nidwalden,6052,2020,2019,-1,0,"15,9"
5046,127,"3,5",Luzern,6052,2020,1880,-140,-40,"14,8"
5048,108,"4,5",Luzern,6015,2150,1528,-622,-138,"14,15"
5050,60,"2,5",Freiburg,1700,1350,915,-435,-174,"15,25"
5051,152,"5,5",Schwyz,8853,4150,2470,-1680,-305,"16,25"
5052,90,"4,5",Zürich,8320,1795,1580,-215,-48,"17,55"
5053,66,"3,5",Bern,3072,1490,944,-546,-156,"14,3"
5054,75,4,Solothurn,2540,1150,968,-182,-46,"12,9"
5056,74,3,St. Gallen,9470,1195,1066,-129,-43,"14,4"
5057,65,"3,5",Appenzell Innerrhoden,9450,990,910,-80,-23,14
5057,65,"3,5",Appenzell Ausserrhoden,9450,990,829,-161,-46,"12,75"
5057,65,"3,5",St. Gallen,9450,990,900,-90,-26,"13,85"
5058,95,"4,5",Zürich,8804,2190,1667,-523,-116,"17,55"
5059,73,"2,5",Solothurn,2540,850,1004,154,62,"13,75"
5060,75,3,Solothurn,2540,980,1020,40,13,"13,6"
5061,75,"4,5",Appenzell Innerrhoden,9450,1195,960,-235,-52,"12,8"
5061,75,"4,5",Appenzell Ausserrhoden,9450,1195,919,-276,-61,"12,25"
5061,75,"4,5",St. Gallen,9450,1195,979,-216,-48,"13,05"
5063,56,"2,5",Thurgau,8360,1260,792,-468,-187,"14,15"
5067,104,"4,5",Waadt,1290,3750,1695,-2055,-457,"16,3"
5067,104,"4,5",Genf,1290,3750,1903,-1847,-410,"18,3"
5069,97,"4,5",Neuchâtel,2017,1940,1208,-732,-163,"12,45"
5070,110,"4,5",Zürich,8180,2120,1931,-189,-42,"17,55"
5072,68,"3,5",Aargau,5074,1700,1000,-700,-200,"14,7"
5074,100,"4,5",Luzern,6004,2490,1415,-1075,-239,"14,15"
5077,84,"3,5",Zürich,8606,2100,1520,-580,-166,"18,1"
5080,117,"3,5",Zürich,8910,2060,2118,58,17,"18,1"
5083,131,"5,5",Aargau,8916,2630,1854,-776,-141,"14,15"
5087,116,"4,5",Aargau,8916,1890,1653,-237,-53,"14,25"
5090,150,"5,5",Aargau,8916,2340,2123,-217,-39,"14,15"
5092,105,"3,5",Zürich,8105,2310,1901,-409,-117,"18,1"
5101,80,"2,5",Tessin,6600,1830,1068,-762,-305,"13,35"
5102,90,"3,5",Tessin,6982,1550,1215,-335,-96,"13,5"
5103,110,"4,5",St. Gallen,9630,1280,1436,156,35,"13,05"
5104,14,1,Zürich,8004,760,305,-455,-455,"21,8"
5106,53,"2,5",Zürich,8800,1960,1044,-916,-366,"19,7"
5107,68,"3,5",Aargau,4310,1430,1000,-430,-123,"14,7"
5110,80,"2,5",Tessin,6600,1770,1068,-702,-281,"13,35"
5112,58,"2,5",Waadt,1820,1620,1027,-593,-237,"17,7"
5114,108,"4,5",Neuchâtel,2300,1749,1345,-404,-90,"12,45"
5115,141,"4,5",Neuchâtel,2300,2166,1755,-411,-91,"12,45"
5116,115,"4,5",Neuchâtel,2300,1798,1432,-366,-81,"12,45"
5117,211,"4,5",Waadt,1009,6950,3439,-3511,-780,"16,3"
5118,141,"4,5",Schwyz,8808,3824,2207,-1617,-359,"15,65"
5119,110,4,Zürich,8008,3990,1925,-2065,-516,"17,5"
5120,72,"3,5",Aargau,5073,1680,1058,-622,-178,"14,7"
5121,180,"4,5",Zürich,8810,4180,3159,-1021,-227,"17,55"
5122,180,"4,5",Zürich,8810,4180,3159,-1021,-227,"17,55"
5123,87,"4,5",Zürich,8810,2755,1527,-1228,-273,"17,55"
5124,52,"2,5",Zürich,8810,1695,1024,-671,-268,"19,7"
5125,54,"3,5",Zürich,8810,1825,977,-848,-242,"18,1"
5127,96,"3,5",Zürich,8004,3700,1738,-1962,-561,"18,1"
5129,67,"2,5",Zürich,8004,2720,1320,-1400,-560,"19,7"
5139,114,"3,5",Aargau,5630,1990,1676,-314,-90,"14,7"
5140,105,"4,5",Aargau,5630,1860,1496,-364,-81,"14,25"
5141,120,"4,5",Luzern,6006,2350,1698,-652,-145,"14,15"
5144,108,"3,5",Aargau,5600,2200,1588,-612,-175,"14,7"
5145,74,"2,5",Aargau,5600,1610,1151,-459,-184,"15,55"
5146,103,"3,5",Aargau,5600,2075,1514,-561,-160,"14,7"
5147,60,3,Zürich,8006,2640,1122,-1518,-506,"18,7"
5148,160,"5,5",St. Gallen,8645,3950,2008,-1942,-353,"12,55"
5150,110,3,Bern,3007,1800,1595,-205,-68,"14,5"
5151,150,"2,5",Aargau,6264,1890,2333,443,177,"15,55"
5151,150,"2,5",Luzern,6264,1890,2415,525,210,"16,1"
5152,87,4,St. Gallen,8716,1780,1157,-623,-156,"13,3"
5153,91,"3,5",Zürich,8915,2260,1647,-613,-175,"18,1"
5155,91,"4,5",Basel-Landschaft,4153,1507,1502,-5,-1,"16,5"
5163,120,"5,5",Aargau,5452,2660,1698,-962,-175,"14,15"
5164,96,"3,5",Aargau,5630,2012,1411,-601,-172,"14,7"
5165,91,"2,5",Zürich,8330,1740,1793,53,21,"19,7"
5166,90,"3,5",Zürich,8610,1990,1629,-361,-103,"18,1"
5170,108,"4,5",Zürich,8196,1680,1895,215,48,"17,55"
5171,110,"4,5",Luzern,6206,2240,1556,-684,-152,"14,15"
5174,50,"2,5",Waadt,1806,1799,885,-914,-366,"17,7"
5175,87,"3,5",Zürich,8001,3988,1575,-2413,-689,"18,1"
5176,77,"2,5",Zürich,8304,1610,1517,-93,-37,"19,7"
5178,120,"4,5",Luzern,6213,1290,1698,408,91,"14,15"
5180,73,"4,5",Genf,1214,2100,1336,-764,-170,"18,3"
5183,70,"2,5",Zürich,8006,2710,1379,-1331,-532,"19,7"
5184,70,"3,5",Waadt,1802,2430,1155,-1275,-364,"16,5"
5185,63,"2,5",Wallis,1870,1230,907,-323,-129,"14,4"
5187,207,"5,5",Zürich,8702,3330,3695,365,66,"17,85"
5188,150,"3,5",Aargau,5057,1900,2205,305,87,"14,7"
5192,76,"3,5",Aargau,5034,1720,1117,-603,-172,"14,7"
5193,85,"4,5",Jura,2822,1150,876,-274,-61,"10,3"
5194,93,"3,5",Basel-Stadt,4057,1920,1558,-362,-103,"16,75"
5195,61,"2,5",Zürich,8246,1470,1202,-268,-107,"19,7"
5196,122,"4,5",Zürich,8246,2160,2141,-19,-4,"17,55"
5197,96,"3,5",Zürich,8246,1950,1738,-212,-61,"18,1"
5198,89,"3,5",Aargau,5034,1760,1308,-452,-129,"14,7"
5200,126,"4,5",Thurgau,8590,2110,1556,-554,-123,"12,35"
5201,90,"3,5",Zürich,8953,1900,1629,-271,-77,"18,1"
5201,90,"3,5",Aargau,8953,1900,1323,-577,-165,"14,7"
5203,70,2,Zürich,8953,1460,1449,-11,-6,"20,7"
5203,70,2,Aargau,8953,1460,1120,-340,-170,16
5204,45,"1,5",Basel-Landschaft,4419,840,767,-73,-49,"17,05"
5205,33,1,Waadt,1006,1040,703,-337,-337,"21,3"
5206,58,"2,5",Schwyz,8840,1550,989,-561,-224,"17,05"
5207,207,6,Solothurn,4228,2490,2732,242,40,"13,2"
5209,52,"2,5",Zürich,8600,1570,1024,-546,-218,"19,7"
5210,75,"3,5",Zürich,8032,3300,1358,-1942,-555,"18,1"
5211,160,"4,5",Zürich,8800,4519,2808,-1711,-380,"17,55"
5212,100,3,Waadt,1820,2250,1710,-540,-180,"17,1"
5214,55,2,Zürich,8001,2990,1139,-1851,-926,"20,7"
5215,27,1,Zürich,8001,2190,589,-1601,-1601,"21,8"
5216,120,"3,5",Zürich,8044,2850,2172,-678,-194,"18,1"
5217,100,"4,5",Zürich,8134,2860,1755,-1105,-246,"17,55"
5218,25,1,Zürich,8001,1990,545,-1445,-1445,"21,8"
5219,60,"3,5",Zürich,8008,3500,1086,-2414,-690,"18,1"
5221,46,"1,5",Zürich,8001,2080,978,-1102,-735,"21,25"
5223,85,3,Wallis,1872,1300,1182,-118,-39,"13,9"
5224,50,"2,5",Luzern,6006,1075,805,-270,-108,"16,1"
5225,93,"3,5",St. Gallen,9000,1480,1288,-192,-55,"13,85"
5229,120,"3,5",Bern,3856,1800,1716,-84,-24,"14,3"
5230,23,1,St. Gallen,8890,510,366,-144,-144,"15,9"
5231,105,"4,5",Bern,3123,1630,1454,-176,-39,"13,85"
5232,59,"2,5",Luzern,6246,1260,950,-310,-124,"16,1"
5233,80,"3,5",Zürich,8008,3500,1448,-2052,-586,"18,1"
5235,85,"3,5",Zürich,8008,3400,1539,-1861,-532,"18,1"
5236,80,4,Wallis,3961,1600,1008,-592,-148,"12,6"
5237,120,4,Wallis,3973,1450,1512,62,16,"12,6"
5238,85,3,Wallis,1872,1300,1182,-118,-39,"13,9"
5239,102,"3,5",Zürich,8180,2285,1846,-439,-125,"18,1"
5240,75,"2,5",Zürich,8953,1870,1478,-392,-157,"19,7"
5240,75,"2,5",Aargau,8953,1870,1166,-704,-282,"15,55"
5241,50,2,St. Gallen,9630,690,770,80,40,"15,4"
5242,80,"2,5",Zürich,8600,1850,1576,-274,-110,"19,7"
5243,98,"4,5",Zürich,8953,2565,1720,-845,-188,"17,55"
5243,98,"4,5",Aargau,8953,2565,1397,-1168,-260,"14,25"
5245,21,1,Waadt,1006,800,447,-353,-353,"21,3"
5246,106,"3,5",Luzern,6210,1820,1569,-251,-72,"14,8"
5247,95,"4,5",St. Gallen,9014,1640,1240,-400,-89,"13,05"
5247,95,"4,5",Appenzell Ausserrhoden,9014,1640,1164,-476,-106,"12,25"
5248,55,"2,5",Graubünden,7000,1310,872,-438,-175,"15,85"
5249,80,"3,5",St. Gallen,9642,1180,1108,-72,-21,"13,85"
5250,110,5,St. Gallen,9011,2100,1408,-692,-138,"12,8"
5251,112,"2,5",Appenzell Ausserrhoden,9103,1180,1557,377,151,"13,9"
5251,112,"2,5",St. Gallen,9103,1180,1669,489,196,"14,9"
5252,110,"3,5",Thurgau,8594,1350,1469,119,34,"13,35"
5253,95,"4,5",Basel-Landschaft,4107,2470,1568,-902,-200,"16,5"
5254,123,"3,5",St. Gallen,9016,1780,1704,-76,-22,"13,85"
5255,70,"2,5",Graubünden,7156,989,1110,121,48,"15,85"
5256,75,4,Basel-Landschaft,4106,1590,1215,-375,-94,"16,2"
5257,25,1,Obwalden,6010,760,398,-362,-362,"15,9"
5257,25,1,Nidwalden,6010,760,365,-395,-395,"14,6"
5257,25,1,Luzern,6010,760,470,-290,-290,"18,8"
5259,15,1,Zürich,8134,850,327,-523,-523,"21,8"
5260,117,"4,5",Aargau,4665,1990,1667,-323,-72,"14,25"
5262,145,"5,5",Aargau,5644,1970,2052,82,15,"14,15"
5263,105,"4,5",Graubünden,7524,2187,1418,-769,-171,"13,5"
5264,35,"2,5",Aargau,4800,1250,544,-706,-282,"15,55"
5267,135,"5,5",Luzern,6204,2800,1910,-890,-162,"14,15"
5268,100,4,Zürich,8118,1990,1750,-240,-60,"17,5"
5270,135,"4,5",Schwyz,6415,2100,2113,13,3,"15,65"
5271,46,"2,5",Nidwalden,6390,1280,766,-514,-206,"16,65"
5271,46,"2,5",Obwalden,6390,1280,658,-622,-249,"14,3"
5271,46,"2,5",Uri,6390,1280,610,-670,-268,"13,25"
5273,21,1,Graubünden,7000,600,393,-207,-207,"18,7"
5274,125,"4,5",Luzern,6017,2150,1769,-381,-85,"14,15"
5275,70,3,Graubünden,7430,1130,1071,-59,-20,"15,3"
5277,32,1,Appenzell Innerrhoden,9050,650,499,-151,-151,"15,6"
5281,74,"3,5",Luzern,6003,3700,1095,-2605,-744,"14,8"
5282,10,1,Basel-Landschaft,4133,500,170,-330,-330,17
5283,139,5,St. Gallen,8880,1790,1779,-11,-2,"12,8"
5284,75,"2,5",Tessin,6850,1080,1001,-79,-32,"13,35"
5288,48,2,St. Gallen,7320,1310,739,-571,-286,"15,4"
5290,112,"4,5",Graubünden,7430,1580,1512,-68,-15,"13,5"
5291,15,1,St. Gallen,7310,1180,239,-941,-941,"15,9"
5292,32,1,St. Gallen,7310,1440,509,-931,-931,"15,9"
5293,48,"2,5",Zürich,8152,1650,946,-704,-282,"19,7"
5294,88,"3,5",St. Gallen,9436,1750,1219,-531,-152,"13,85"
5295,62,"2,5",Appenzell Innerrhoden,9050,1190,812,-378,-151,"13,1"
5296,60,"2,5",Glarus,8762,990,837,-153,-61,"13,95"
5297,106,"4,5",Luzern,6182,1570,1500,-70,-16,"14,15"
5298,111,"4,5",St. Gallen,8882,1890,1449,-441,-98,"13,05"
5299,120,"5,5",Graubünden,7302,1550,1446,-104,-19,"12,05"
5300,120,"4,5",Luzern,6005,3300,1698,-1602,-356,"14,15"
5303,76,3,Basel-Stadt,4051,1763,1277,-486,-162,"16,8"
5304,120,"5,5",Luzern,6018,2050,1698,-352,-64,"14,15"
5305,72,"3,5",Luzern,6234,1300,1066,-234,-67,"14,8"
5306,70,3,Luzern,6212,1650,1078,-572,-191,"15,4"
5307,75,"4,5",Aargau,5726,1280,1069,-211,-47,"14,25"
5308,115,"4,5",Luzern,6404,1880,1627,-253,-56,"14,15"
5309,115,"4,5",Luzern,6404,1920,1627,-293,-65,"14,15"
5310,85,"3,5",Zug,6340,2700,1628,-1072,-306,"19,15"
5311,135,"5,5",Luzern,6204,2800,1910,-890,-162,"14,15"
5312,125,"4,5",Graubünden,7204,1690,1688,-2,0,"13,5"
5313,96,"4,5",Zürich,8044,3749,1685,-2064,-459,"17,55"
5314,95,"4,5",St. Gallen,9100,1400,1240,-160,-36,"13,05"
5314,95,"4,5",Appenzell Ausserrhoden,9100,1400,1164,-236,-52,"12,25"
5315,50,"2,5",Graubünden,7152,1520,793,-727,-291,"15,85"
5317,115,"4,5",Luzern,6353,1950,1627,-323,-72,"14,15"
5320,110,5,Luzern,6034,1660,1551,-109,-22,"14,1"
5320,110,5,Aargau,6034,1660,1562,-98,-20,"14,2"
5321,87,"4,5",Graubünden,7206,1590,1175,-415,-92,"13,5"
5323,59,"2,5",Appenzell Innerrhoden,9450,720,773,53,21,"13,1"
5323,59,"2,5",Appenzell Ausserrhoden,9450,720,820,100,40,"13,9"
5323,59,"2,5",St. Gallen,9450,720,879,159,64,"14,9"
5324,125,"2,5",Aargau,5400,2586,1944,-642,-257,"15,55"
5328,53,2,St. Gallen,9008,1390,816,-574,-287,"15,4"
5329,90,"4,5",Luzern,6003,2190,1273,-917,-204,"14,15"
5330,80,"3,5",Bern,3432,910,1144,234,67,"14,3"
5331,110,"4,5",Bern,3857,1300,1524,224,50,"13,85"
5332,65,"2,5",St. Gallen,9430,900,969,69,28,"14,9"
5333,120,"3,5",Graubünden,7000,940,1806,866,247,"15,05"
5337,135,"4,5",Zug,6315,2850,2531,-319,-71,"18,75"
5337,135,"4,5",Schwyz,6315,2850,2113,-737,-164,"15,65"
5338,70,"2,5",Basel-Landschaft,4497,1435,1183,-252,-101,"16,9"
5340,80,"3,5",Aargau,5415,1280,1176,-104,-30,"14,7"
5345,48,"2,5",St. Gallen,9000,1080,715,-365,-146,"14,9"
5347,100,"4,5",Obwalden,6010,1496,1320,-176,-39,"13,2"
5347,100,"4,5",Nidwalden,6010,1496,1500,4,1,15
5347,100,"4,5",Luzern,6010,1496,1415,-81,-18,"14,15"
5351,200,"5,5",Thurgau,9500,2235,2370,135,25,"11,85"
5351,200,"5,5",St. Gallen,9500,2235,2510,275,50,"12,55"
5355,91,"3,5",Luzern,6003,2200,1347,-853,-244,"14,8"
5356,195,"5,5",Obwalden,6055,2990,2447,-543,-99,"12,55"
5358,107,"4,5",St. Gallen,8887,1530,1396,-134,-30,"13,05"
5359,75,3,Graubünden,7000,1565,1148,-417,-139,"15,3"
5361,55,"2,5",Aargau,5018,980,855,-125,-50,"15,55"
5362,70,"2,5",Tessin,6822,1200,935,-265,-106,"13,35"
5363,65,"3,5",St. Gallen,9000,930,900,-30,-9,"13,85"
5366,50,2,St. Gallen,9466,1030,770,-260,-130,"15,4"
5368,36,2,Luzern,6106,820,605,-215,-108,"16,8"
5369,100,"3,5",St. Gallen,9107,1665,1385,-280,-80,"13,85"
5369,100,"3,5",Appenzell Innerrhoden,9107,1665,1400,-265,-76,14
5369,100,"3,5",Appenzell Ausserrhoden,9107,1665,1275,-390,-111,"12,75"
5374,52,2,Appenzell Innerrhoden,9450,850,582,-268,-134,"11,2"
5374,52,2,Appenzell Ausserrhoden,9450,850,780,-70,-35,15
5374,52,2,St. Gallen,9450,850,801,-49,-25,"15,4"
5375,70,"3,5",Aargau,5736,1090,1029,-61,-17,"14,7"
5376,90,"3,5",St. Gallen,9436,1650,1247,-403,-115,"13,85"
5377,113,"4,5",Zürich,8185,2080,1983,-97,-22,"17,55"
5378,80,"3,5",Neuchâtel,2400,1180,956,-224,-64,"11,95"
5379,50,2,Basel-Stadt,4051,1460,910,-550,-275,"18,2"
5383,54,"2,5",Aargau,5630,1260,840,-420,-168,"15,55"
5384,60,2,Zürich,8154,1480,1242,-238,-119,"20,7"
5386,85,"3,5",Aargau,5106,1250,1250,0,0,"14,7"
5387,115,"4,5",Wallis,1950,1590,1461,-129,-29,"12,7"
5392,80,"3,5",Waadt,1820,3275,1320,-1955,-559,"16,5"
5394,86,"3,5",Zürich,8915,2270,1557,-713,-204,"18,1"
5395,140,"4,5",Tessin,6883,1900,1939,39,9,"13,85"
5396,90,4,Aargau,5430,1980,1287,-693,-173,"14,3"
5398,62,"2,5",Basel-Landschaft,4410,1370,1048,-322,-129,"16,9"
5399,47,"2,5",St. Gallen,9100,960,700,-260,-104,"14,9"
5399,47,"2,5",Appenzell Ausserrhoden,9100,960,653,-307,-123,"13,9"
5400,74,"2,5",Zug,6330,2104,1524,-580,-232,"20,6"
5401,84,"3,5",Zürich,8424,1995,1520,-475,-136,"18,1"
5402,79,"3,5",Zürich,8134,1930,1430,-500,-143,"18,1"
5403,86,"3,5",Zürich,8041,2160,1557,-603,-172,"18,1"
5404,46,1,Waadt,1003,1260,980,-280,-280,"21,3"
5405,32,1,Neuchâtel,2000,835,381,-454,-454,"11,9"
5407,90,"3,5",Zürich,8048,2495,1629,-866,-247,"18,1"
5408,75,"2,5",Zürich,8702,2310,1478,-832,-333,"19,7"
5409,98,5,Waadt,1020,2810,1637,-1173,-235,"16,7"
5410,108,"4,5",Zürich,8174,2190,1895,-295,-66,"17,55"
5411,93,4,St. Gallen,9100,1470,1237,-233,-58,"13,3"
5411,93,4,Appenzell Ausserrhoden,9100,1470,1181,-289,-72,"12,7"
5412,93,"2,5",Schaffhausen,8200,2150,1335,-815,-326,"14,35"
5413,87,"4,5",Schaffhausen,8207,1435,1135,-300,-67,"13,05"
5414,105,"5,5",Schaffhausen,8207,1725,1407,-318,-58,"13,4"
5415,105,"5,5",Schaffhausen,8207,1605,1407,-198,-36,"13,4"
5416,124,"4,5",Thurgau,9500,1700,1531,-169,-38,"12,35"
5416,124,"4,5",St. Gallen,9500,1700,1618,-82,-18,"13,05"
5418,96,"4,5",Waadt,1004,3080,1565,-1515,-337,"16,3"
5419,39,"1,5",Waadt,1004,990,772,-218,-145,"19,8"
5420,70,3,Waadt,1009,1940,1197,-743,-248,"17,1"
5421,50,"2,5",Bern,2503,1240,743,-497,-199,"14,85"
5422,50,"2,5",Bern,2543,860,743,-117,-47,"14,85"
5423,55,3,Freiburg,1723,1245,814,-431,-144,"14,8"
5424,78,"3,5",Bern,3072,1450,1115,-335,-96,"14,3"
5427,105,"4,5",Zürich,8152,2250,1843,-407,-90,"17,55"
5430,70,"3,5",Aargau,5430,1650,1029,-621,-177,"14,7"
5431,58,2,Aargau,5106,990,928,-62,-31,16
5432,50,"1,5",Zürich,8008,2235,1063,-1172,-781,"21,25"
5434,91,"4,5",Zürich,8427,1600,1597,-3,-1,"17,55"
5435,102,4,Zürich,8704,2630,1785,-845,-211,"17,5"
5436,79,4,Zürich,8004,2200,1383,-817,-204,"17,5"
5437,105,"4,5",Schaffhausen,8200,1980,1370,-610,-136,"13,05"
5440,130,"4,5",Nidwalden,6362,4500,1950,-2550,-567,15
5441,65,3,Zürich,8053,2390,1216,-1174,-391,"18,7"
5443,90,3,Basel-Landschaft,4052,1750,1503,-247,-82,"16,7"
5443,90,3,Basel-Stadt,4052,1750,1512,-238,-79,"16,8"
5444,73,2,Basel-Stadt,4051,1650,1329,-321,-161,"18,2"
5445,89,"3,5",Zürich,8953,1690,1611,-79,-23,"18,1"
5445,89,"3,5",Aargau,8953,1690,1308,-382,-109,"14,7"
5446,93,"3,5",Freiburg,1630,1700,1316,-384,-110,"14,15"
5447,88,"3,5",Basel-Landschaft,4242,2220,1448,-772,-221,"16,45"
5448,88,"3,5",Basel-Landschaft,4242,2140,1448,-692,-198,"16,45"
5450,150,"4,5",Luzern,6215,1690,2123,433,96,"14,15"
5451,83,"3,5",Basel-Landschaft,4242,1980,1365,-615,-176,"16,45"
5452,71,"2,5",Basel-Landschaft,4242,2040,1200,-840,-336,"16,9"
5453,51,"2,5",Tessin,6987,1250,681,-569,-228,"13,35"
5454,90,"3,5",Tessin,6512,1600,1215,-385,-110,"13,5"
5455,85,"3,5",Tessin,6913,1400,1148,-252,-72,"13,5"
5456,151,"4,5",Tessin,6900,2830,2091,-739,-164,"13,85"
5457,80,"2,5",Tessin,6934,1550,1068,-482,-193,"13,35"
5460,158,"5,5",Zürich,8134,4800,2820,-1980,-360,"17,85"
5461,115,"5,5",Zürich,8180,2036,2053,17,3,"17,85"
5462,95,"3,5",Graubünden,7260,2300,1430,-870,-249,"15,05"
5464,95,"2,5",Appenzell Innerrhoden,9056,1950,1245,-705,-282,"13,1"
5464,95,"2,5",Appenzell Ausserrhoden,9056,1950,1321,-629,-252,"13,9"
5465,118,"4,5",Aargau,4313,2300,1682,-618,-137,"14,25"
5467,60,3,Basel-Landschaft,4127,1310,1002,-308,-103,"16,7"
5468,74,"3,5",Freiburg,1680,1280,1047,-233,-67,"14,15"
5473,80,"2,5",Graubünden,7083,1100,1268,168,67,"15,85"
5474,100,"4,5",St. Gallen,9014,350,1305,955,212,"13,05"
5474,100,"4,5",Appenzell Ausserrhoden,9014,350,1225,875,194,"12,25"
5477,53,"2,5",Zürich,8600,1760,1044,-716,-286,"19,7"
5478,123,"3,5",Thurgau,8356,1755,1642,-113,-32,"13,35"
5479,37,1,Basel-Stadt,4000,990,648,-342,-342,"17,5"
5484,110,"4,5",St. Gallen,9462,2080,1436,-644,-143,"13,05"
5486,100,"3,5",Waadt,1510,1650,1650,0,0,"16,5"
5488,79,3,Basel-Stadt,4055,1495,1327,-168,-56,"16,8"
5489,110,5,Thurgau,9545,1200,1309,109,22,"11,9"
5490,105,"3,5",Solothurn,4652,1880,1391,-489,-140,"13,25"
5491,70,3,Aargau,5400,1460,1057,-403,-134,"15,1"
5494,108,"4,5",Aargau,4656,1490,1539,49,11,"14,25"
5494,108,"4,5",Solothurn,4656,1490,1393,-97,-22,"12,9"
5496,124,"4,5",Solothurn,4612,1650,1600,-50,-11,"12,9"
5497,76,3,Solothurn,4612,1180,1034,-146,-49,"13,6"
5499,122,"4,5",Aargau,4665,1980,1739,-241,-54,"14,25"
5503,135,"5,5",Aargau,4665,1800,1910,110,20,"14,15"
5509,86,"3,5",Aargau,5018,1760,1264,-496,-142,"14,7"
5512,87,"4,5",Solothurn,4654,1340,1122,-218,-48,"12,9"
5513,41,"2,5",Aargau,5018,1010,638,-372,-149,"15,55"
5514,99,"4,5",Aargau,5018,2130,1411,-719,-160,"14,25"
5515,70,"2,5",Basel-Stadt,4057,1800,1225,-575,-230,"17,5"
5516,94,"2,5",Aargau,5626,1195,1462,267,107,"15,55"
5517,60,"3,5",Aargau,5430,1222,882,-340,-97,"14,7"
5519,86,3,Luzern,6244,1650,1324,-326,-109,"15,4"
5520,52,"2,5",Genf,1224,2600,970,-1630,-652,"18,65"
5521,90,"4,5",Zürich,8196,2100,1580,-520,-116,"17,55"
5522,130,"4,5",Zug,6317,3400,2438,-962,-214,"18,75"
5524,125,"5,5",Bern,4900,1890,1694,-196,-36,"13,55"
5525,90,3,Solothurn,4657,1350,1224,-126,-42,"13,6"
5526,100,5,Zürich,8637,1420,1760,340,68,"17,6"
5526,100,5,St. Gallen,8637,1420,1280,-140,-28,"12,8"
5527,150,"5,5",Solothurn,4657,2000,1958,-42,-8,"13,05"
5528,138,"5,5",Zürich,8616,2170,2463,293,53,"17,85"
5530,85,3,Tessin,6930,1350,1148,-202,-67,"13,5"
5534,57,"2,5",Aargau,5417,1380,886,-494,-198,"15,55"
5535,90,"4,5",Graubünden,7000,1850,1215,-635,-141,"13,5"
5536,20,1,Bern,2502,750,320,-430,-430,16
5537,115,"3,5",Aargau,5620,2740,1691,-1049,-300,"14,7"
5538,140,"4,5",Aargau,5277,1975,1995,20,4,"14,25"
5540,65,"2,5",Zürich,8196,1290,1281,-9,-4,"19,7"
5541,62,3,Basel-Stadt,4058,1580,1042,-538,-179,"16,8"
5542,33,1,Aargau,5603,1120,538,-582,-582,"16,3"
5543,100,"4,5",Bern,4922,1930,1385,-545,-121,"13,85"
5546,14,1,Thurgau,8500,650,193,-457,-457,"13,8"
5546,14,1,Zürich,8500,650,305,-345,-345,"21,8"
5547,50,2,Zürich,8340,1140,1035,-105,-53,"20,7"
5548,145,5,Basel-Landschaft,4052,3750,2436,-1314,-263,"16,8"
5548,145,5,Basel-Stadt,4052,3750,2509,-1241,-248,"17,3"
5549,150,"4,5",Thurgau,8500,2530,1853,-677,-150,"12,35"
5549,150,"4,5",Zürich,8500,2530,2633,103,23,"17,55"
5550,65,2,Thurgau,8500,1490,936,-554,-277,"14,4"
5550,65,2,Zürich,8500,1490,1346,-144,-72,"20,7"
5551,75,"3,5",Graubünden,7000,1510,1129,-381,-109,"15,05"
5554,63,3,Zürich,8172,1440,1178,-262,-87,"18,7"
5557,78,2,Zürich,8008,3000,1615,-1385,-693,"20,7"
5558,75,4,Zürich,8172,1710,1313,-397,-99,"17,5"
5559,94,"3,5",Waadt,1820,3500,1551,-1949,-557,"16,5"
5560,117,"4,5",Luzern,6005,3925,1656,-2269,-504,"14,15"
5561,134,"5,5",Zürich,8625,2540,2392,-148,-27,"17,85"
5566,104,"3,5",Aargau,5452,1750,1529,-221,-63,"14,7"
5567,110,"4,5",St. Gallen,9400,1430,1436,6,1,"13,05"
5568,57,"3,5",Tessin,6710,890,770,-120,-34,"13,5"
5569,85,"3,5",St. Gallen,9326,1560,1177,-383,-109,"13,85"
5569,85,"3,5",Thurgau,9326,1560,1135,-425,-121,"13,35"
5570,86,5,Tessin,6710,1340,1221,-119,-24,"14,2"
5572,18,1,Wallis,3900,1200,313,-887,-887,"17,4"
5575,52,2,Basel-Stadt,4059,1480,946,-534,-267,"18,2"
5578,111,5,St. Gallen,9000,1964,1421,-543,-109,"12,8"
5579,71,"3,5",Basel-Landschaft,4107,1910,1168,-742,-212,"16,45"
5580,77,"2,5",Aargau,5079,1290,1197,-93,-37,"15,55"
5582,76,"2,5",Zürich,8800,2450,1497,-953,-381,"19,7"
5583,120,"4,5",Zürich,8102,3600,2106,-1494,-332,"17,55"
5584,121,"4,5",Zürich,8102,3500,2124,-1376,-306,"17,55"
5586,161,"4,5",Zürich,8102,4450,2826,-1624,-361,"17,55"
5587,120,"4,5",Zürich,8197,2165,2106,-59,-13,"17,55"
5589,128,"5,5",Aargau,5075,1780,1811,31,6,"14,15"
5590,113,"3,5",Zürich,8102,3250,2045,-1205,-344,"18,1"
5591,123,"3,5",Aargau,5610,2310,1808,-502,-143,"14,7"
5596,130,"4,5",Appenzell Ausserrhoden,9103,1600,1593,-7,-2,"12,25"
5596,130,"4,5",St. Gallen,9103,1600,1697,97,22,"13,05"
5598,164,"3,5",Zürich,8352,2775,2968,193,55,"18,1"
5600,90,"4,5",Bern,3754,1620,1247,-373,-83,"13,85"
5602,61,3,Thurgau,8370,1270,848,-422,-141,"13,9"
5603,90,3,St. Gallen,9630,1130,1296,166,55,"14,4"
5604,78,"2,5",St. Gallen,8735,1230,1162,-68,-27,"14,9"
5606,90,3,Bern,2502,1280,1305,25,8,"14,5"
5607,85,4,Zürich,8618,1780,1488,-292,-73,"17,5"
5608,132,"5,5",Aargau,4315,2572,1868,-704,-128,"14,15"
5609,75,"2,5",Zürich,8706,2650,1478,-1172,-469,"19,7"
5610,160,"4,5",Zürich,8180,2450,2808,358,80,"17,55"
5611,205,"5,5",Zug,6343,8800,4223,-4577,-832,"20,6"
5612,105,"4,5",Aargau,5303,2045,1496,-549,-122,"14,25"
5613,80,"3,5",Zürich,8320,1600,1448,-152,-43,"18,1"
5614,87,"3,5",Solothurn,4653,1285,1153,-132,-38,"13,25"
5615,70,"2,5",Zürich,8304,2200,1379,-821,-328,"19,7"
5616,119,"4,5",St. Gallen,9244,1780,1553,-227,-50,"13,05"
5617,65,"3,5",Zürich,8345,1550,1177,-373,-107,"18,1"
5619,77,"3,5",Zürich,8003,3490,1394,-2096,-599,"18,1"
5621,65,3,Basel-Landschaft,4132,1300,1086,-214,-71,"16,7"
5622,55,2,Zürich,8004,1800,1139,-661,-331,"20,7"
5623,115,"4,5",Zürich,8625,2650,2018,-632,-140,"17,55"
5624,120,"4,5",Basel-Stadt,4054,2940,2040,-900,-200,17
5627,35,2,Zug,6300,1200,760,-440,-220,"21,7"
5628,88,"3,5",Bern,3110,2140,1258,-882,-252,"14,3"
5629,96,"4,5",Zürich,8105,1890,1685,-205,-46,"17,55"
5630,48,3,Zürich,8608,1190,898,-292,-97,"18,7"
5631,25,1,Zürich,8001,1435,545,-890,-890,"21,8"
5632,149,"4,5",Aargau,5042,2400,2123,-277,-62,"14,25"
5633,68,"3,5",Freiburg,1700,1390,962,-428,-122,"14,15"
5634,109,"4,5",Zürich,8180,2633,1913,-720,-160,"17,55"
5635,120,"5,5",St. Gallen,8737,2050,1506,-544,-99,"12,55"
5636,106,"3,5",Tessin,6850,1480,1431,-49,-14,"13,5"
5637,75,"4,5",Zürich,8424,1593,1316,-277,-62,"17,55"
5641,78,"3,5",Schwyz,8807,1990,1260,-730,-209,"16,15"
5642,136,"5,5",Zürich,8634,2300,2428,128,23,"17,85"
5643,107,4,Zürich,8052,2000,1873,-127,-32,"17,5"
5644,30,1,Zürich,8048,1050,654,-396,-396,"21,8"
5647,92,"4,5",Solothurn,4653,1580,1187,-393,-87,"12,9"
5649,140,"4,5",Basel-Landschaft,4106,2400,2310,-90,-20,"16,5"
5651,50,2,St. Gallen,9466,1030,770,-260,-130,"15,4"
5655,196,"5,5",Schwyz,8806,4850,3185,-1665,-303,"16,25"
5656,67,"3,5",Zürich,8400,1995,1213,-782,-223,"18,1"
5658,78,3,Zürich,8125,1850,1459,-391,-130,"18,7"
5659,230,"5,5",Zürich,8602,4250,4106,-144,-26,"17,85"
5660,150,"4,5",Schwyz,8806,3415,2348,-1067,-237,"15,65"
5661,80,"2,5",Zürich,8053,2020,1576,-444,-178,"19,7"
5662,62,"2,5",Zürich,8400,1790,1221,-569,-228,"19,7"
5663,95,"3,5",Basel-Stadt,4056,2100,1591,-509,-145,"16,75"
5664,93,"3,5",Aargau,4852,1840,1367,-473,-135,"14,7"
5665,80,"4,5",Zürich,8805,1750,1404,-346,-77,"17,55"
5668,92,"4,5",Zürich,8212,1680,1615,-65,-14,"17,55"
5668,92,"4,5",Schaffhausen,8212,1680,1201,-479,-106,"13,05"
5669,75,"3,5",St. Gallen,8722,1395,1039,-356,-102,"13,85"
5675,62,"3,5",Schwyz,6414,1370,1001,-369,-105,"16,15"
5677,90,4,Bern,3035,1480,1269,-211,-53,"14,1"
5678,75,"3,5",St. Gallen,9030,1090,1039,-51,-15,"13,85"
5679,89,"3,5",Bern,3014,1985,1273,-712,-203,"14,3"
5682,45,2,Bern,3465,910,684,-226,-113,"15,2"
5691,200,"5,5",St. Gallen,7310,2400,2510,110,20,"12,55"
5692,35,1,Bern,3800,750,560,-190,-190,16
5693,40,"1,5",St. Gallen,9244,800,626,-174,-116,"15,65"
5694,90,3,Bern,4537,1100,1305,205,68,"14,5"
5697,48,2,Bern,3706,950,730,-220,-110,"15,2"
5698,60,"2,5",Bern,2504,1111,891,-220,-88,"14,85"
5706,70,"2,5",Bern,3778,1260,1040,-220,-88,"14,85"
5707,152,"4,5",Bern,3173,2235,2105,-130,-29,"13,85"
5708,70,3,Bern,3283,1325,1015,-310,-103,"14,5"
5709,107,"4,5",Bern,3122,2290,1482,-808,-180,"13,85"
5711,85,"3,5",Bern,3065,1335,1216,-119,-34,"14,3"
5715,69,"3,5",Bern,3427,1145,987,-158,-45,"14,3"
5716,70,"3,5",St. Gallen,9657,1150,970,-180,-51,"13,85"
5717,64,"2,5",Bern,3322,1170,950,-220,-88,"14,85"
5718,42,2,Bern,3007,957,638,-319,-160,"15,2"
5719,120,"4,5",St. Gallen,9552,1120,1566,446,99,"13,05"
5723,37,1,Bern,3013,1085,592,-493,-493,16
5724,140,"4,5",St. Gallen,7324,1720,1827,107,24,"13,05"
5725,110,"5,5",St. Gallen,9656,1000,1381,381,69,"12,55"
5726,80,3,St. Gallen,9434,1140,1152,12,4,"14,4"
5728,60,"2,5",St. Gallen,9434,1000,894,-106,-42,"14,9"
5729,130,4,Bern,3272,1490,1833,343,86,"14,1"
5730,60,"2,5",Bern,3172,1780,891,-889,-356,"14,85"
5733,86,"3,5",Bern,3800,1600,1230,-370,-106,"14,3"
5735,117,"4,5",Bern,3225,2230,1620,-610,-136,"13,85"
5736,74,"3,5",St. Gallen,9466,1315,1025,-290,-83,"13,85"
5737,120,"3,5",Solothurn,4710,1850,1590,-260,-74,"13,25"
5739,169,"4,5",Aargau,5607,2480,2408,-72,-16,"14,25"
5748,111,1,Zürich,8064,1450,2420,970,970,"21,8"
5749,111,1,Zürich,8064,1450,2420,970,970,"21,8"
5750,34,1,Zürich,8051,1090,741,-349,-349,"21,8"
5753,60,3,Thurgau,8500,1300,834,-466,-155,"13,9"
5753,60,3,Zürich,8500,1300,1122,-178,-59,"18,7"
5755,80,"3,5",Zürich,8052,1990,1448,-542,-155,"18,1"
5756,60,3,Aargau,5611,1500,906,-594,-198,"15,1"
5757,45,"2,5",St. Gallen,9000,950,671,-279,-112,"14,9"
5758,67,"3,5",Zug,6300,1850,1283,-567,-162,"19,15"
5759,110,"3,5",Solothurn,4206,1700,1458,-242,-69,"13,25"
5760,85,"3,5",Zürich,8049,2729,1539,-1190,-340,"18,1"
5764,47,"2,5",Wallis,3929,1200,677,-523,-209,"14,4"
5765,127,"4,5",Obwalden,6010,2200,1676,-524,-116,"13,2"
5765,127,"4,5",Nidwalden,6010,2200,1905,-295,-66,15
5765,127,"4,5",Luzern,6010,2200,1797,-403,-90,"14,15"
5766,61,"2,5",Aargau,5200,1285,949,-336,-134,"15,55"
5767,55,"2,5",Luzern,6048,1080,886,-194,-78,"16,1"
5785,40,1,Schwyz,8750,800,716,-84,-84,"17,9"
5785,40,1,Glarus,8750,800,508,-292,-292,"12,7"
5786,86,"3,5",Aargau,5212,1590,1264,-326,-93,"14,7"
5792,81,4,Bern,3770,1800,1142,-658,-165,"14,1"
5795,90,"3,5",Zürich,8002,2850,1629,-1221,-349,"18,1"
5796,122,"4,5",Luzern,6026,1780,1726,-54,-12,"14,15"
5797,90,"3,5",Zürich,8002,2700,1629,-1071,-306,"18,1"
5798,68,3,Bern,3770,1500,986,-514,-171,"14,5"
5799,77,3,Waadt,1004,2300,1317,-983,-328,"17,1"
5800,79,"3,5",Waadt,1043,2090,1304,-786,-225,"16,5"
5804,95,"3,5",Waadt,1162,2700,1568,-1132,-323,"16,5"
5805,77,"2,5",Waadt,1180,1700,1363,-337,-135,"17,7"
5807,100,4,Genf,1206,3150,1810,-1340,-335,"18,1"
5808,60,3,Genf,1233,2500,1110,-1390,-463,"18,5"
5811,135,"5,5",Waadt,1276,2500,2295,-205,-37,17
5812,127,"4,5",Waadt,1297,3200,2070,-1130,-251,"16,3"
5814,72,"3,5",Waadt,1407,1550,1188,-362,-103,"16,5"
5815,138,"4,5",Waadt,1607,2190,2249,59,13,"16,3"
5816,100,"3,5",Waadt,1801,1850,1650,-200,-57,"16,5"
5817,120,"4,5",Waadt,1822,3300,1956,-1344,-299,"16,3"
5818,200,6,Waadt,1822,4600,3460,-1140,-190,"17,3"
5819,55,3,Wallis,1873,1250,765,-485,-162,"13,9"
5820,90,"3,5",Neuchâtel,2000,1565,1076,-489,-140,"11,95"
5821,82,"3,5",Neuchâtel,2300,900,980,80,23,"11,95"
5822,92,"4,5",Neuchâtel,2300,1100,1145,45,10,"12,45"
5824,150,"4,5",Neuchâtel,2000,2600,1868,-732,-163,"12,45"
5825,13,1,Basel-Stadt,4057,800,228,-572,-572,"17,5"
5860,70,4,St. Gallen,9643,990,931,-59,-15,"13,3"
5862,225,"5,5",Genf,1298,4500,4624,124,23,"20,55"
5863,101,"3,5",St. Gallen,8636,2045,1399,-646,-185,"13,85"
5863,101,"3,5",Zürich,8636,2045,1828,-217,-62,"18,1"
5865,75,"3,5",Waadt,1026,1910,1238,-672,-192,"16,5"
5867,76,"2,5",St. Gallen,9434,1190,1132,-58,-23,"14,9"
5868,115,"4,5",Wallis,1904,1670,1461,-209,-46,"12,7"
5869,75,4,Neuchâtel,2300,1320,915,-405,-101,"12,2"
5870,140,2,Luzern,6014,1790,2352,562,281,"16,8"
5871,70,"3,5",Basel-Landschaft,4153,1650,1152,-498,-142,"16,45"
5872,90,"4,5",Graubünden,7212,1270,1215,-55,-12,"13,5"
5874,118,"4,5",Freiburg,1728,1885,1593,-292,-65,"13,5"
5875,120,"4,5",Zürich,8451,2500,2106,-394,-88,"17,55"
5877,120,"3,5",Zürich,8618,2350,2172,-178,-51,"18,1"
5879,80,4,Neuchâtel,2000,1700,976,-724,-181,"12,2"
5880,200,2,Aargau,5703,2260,3200,940,470,16
5882,82,"3,5",Solothurn,4614,1470,1087,-383,-109,"13,25"
5883,62,"3,5",Waadt,1290,2100,1023,-1077,-308,"16,5"
5883,62,"3,5",Genf,1290,2100,1135,-965,-276,"18,3"
5885,70,"2,5",Waadt,1012,1600,1239,-361,-144,"17,7"
5886,17,1,Bern,3646,660,272,-388,-388,16
5889,98,"3,5",Obwalden,6062,2040,1352,-688,-197,"13,8"
5895,102,"3,5",St. Gallen,8863,2130,1413,-717,-205,"13,85"
5895,102,"3,5",Schwyz,8863,2130,1647,-483,-138,"16,15"
5897,107,"4,5",Aargau,5054,1430,1525,95,21,"14,25"
5898,50,"2,5",Aargau,5737,1070,778,-292,-117,"15,55"
5900,68,"2,5",Zürich,8706,3650,1340,-2310,-924,"19,7"
5902,121,"5,5",Luzern,6154,1675,1712,37,7,"14,15"
5904,80,"3,5",Solothurn,4412,1398,1060,-338,-97,"13,25"
5904,80,"3,5",Basel-Landschaft,4412,1398,1316,-82,-23,"16,45"
5907,117,"4,5",Schwyz,8730,2150,1831,-319,-71,"15,65"
5907,117,"4,5",St. Gallen,8730,2150,1527,-623,-138,"13,05"
5908,115,"4,5",St. Gallen,8863,2760,1501,-1259,-280,"13,05"
5908,115,"4,5",Schwyz,8863,2760,1800,-960,-213,"15,65"
5910,82,"3,5",St. Gallen,8880,1850,1136,-714,-204,"13,85"
5916,125,"3,5",Thurgau,8507,2280,1669,-611,-175,"13,35"
5917,80,"3,5",Nidwalden,6052,1760,1272,-488,-139,"15,9"
5917,80,"3,5",Luzern,6052,1760,1184,-576,-165,"14,8"
5918,200,6,Genf,1246,4800,4520,-280,-47,"22,6"
5919,75,4,Neuchâtel,2300,1220,915,-305,-76,"12,2"
5922,70,"3,5",Basel-Landschaft,4153,1750,1152,-598,-171,"16,45"
5924,70,"3,5",Waadt,1800,1810,1155,-655,-187,"16,5"
5925,70,"2,5",St. Gallen,9000,1525,1043,-482,-193,"14,9"
5928,120,"4,5",Nidwalden,6375,2150,1800,-350,-78,15
5930,120,"4,5",Uri,6487,1400,1524,124,28,"12,7"
5931,120,"5,5",Waadt,1822,2950,2040,-910,-165,17
5934,102,4,Waadt,1820,2290,1622,-668,-167,"15,9"
5936,78,"3,5",Bern,3015,2000,1115,-885,-253,"14,3"
5937,82,"3,5",Waadt,1009,2651,1353,-1298,-371,"16,5"
5938,112,"3,5",Schwyz,6430,1650,1809,159,45,"16,15"
5940,152,"4,5",Luzern,6006,3900,2151,-1749,-389,"14,15"
5941,120,"5,5",Basel-Landschaft,4463,1750,2112,362,66,"17,6"
5943,95,4,Bern,2502,1700,1340,-360,-90,"14,1"
5945,70,"3,5",Waadt,1800,1950,1155,-795,-227,"16,5"
5947,140,"5,5",Aargau,5453,2950,1981,-969,-176,"14,15"
5950,105,"4,5",Freiburg,1470,2215,1418,-797,-177,"13,5"
5952,108,4,Waadt,1148,2200,1717,-483,-121,"15,9"
5953,102,"3,5",Tessin,6600,1550,1377,-173,-49,"13,5"
5954,62,"2,5",Tessin,6600,1150,828,-322,-129,"13,35"
5955,154,6,Waadt,1802,3900,2664,-1236,-206,"17,3"
5956,120,"3,5",Waadt,1844,2700,1980,-720,-206,"16,5"
5957,163,5,Waadt,1820,12000,2722,-9278,-1856,"16,7"
5960,125,"2,5",Waadt,1820,2750,2213,-537,-215,"17,7"
5961,154,6,Waadt,1802,3900,2664,-1236,-206,"17,3"
5962,80,"3,5",Waadt,1820,2600,1320,-1280,-366,"16,5"
5963,151,"5,5",Waadt,1802,2980,2567,-413,-75,17
5965,256,"4,5",Zürich,8492,2660,4493,1833,407,"17,55"
5966,52,"2,5",Waadt,1010,1540,920,-620,-248,"17,7"
5967,50,"2,5",Waadt,1023,1465,885,-580,-232,"17,7"
5969,82,"2,5",Tessin,6900,1550,1095,-455,-182,"13,35"
5971,220,"5,5",Basel-Landschaft,4132,5400,3872,-1528,-278,"17,6"
5973,75,"3,5",Zürich,8909,1491,1358,-133,-38,"18,1"
5974,103,"3,5",Zürich,8955,1993,1864,-129,-37,"18,1"
5978,92,"4,5",Neuchâtel,2300,1100,1145,45,10,"12,45"
5979,82,"3,5",Neuchâtel,2300,900,980,80,23,"11,95"
5983,76,"3,5",Schaffhausen,8200,1690,999,-691,-197,"13,15"
5984,95,"3,5",Waadt,1162,2700,1568,-1132,-323,"16,5"
5985,200,6,Waadt,1822,4600,3460,-1140,-190,"17,3"
5986,60,3,Genf,1233,2500,1110,-1390,-463,"18,5"
5988,77,3,Waadt,1004,2300,1317,-983,-328,"17,1"
5989,138,"4,5",Waadt,1607,2190,2249,59,13,"16,3"
5990,90,"3,5",Neuchâtel,2000,1565,1076,-489,-140,"11,95"
5991,127,"4,5",Waadt,1297,3200,2070,-1130,-251,"16,3"
5992,100,"3,5",Waadt,1801,1850,1650,-200,-57,"16,5"
5995,55,3,Wallis,1873,1250,765,-485,-162,"13,9"
5997,120,"4,5",Waadt,1822,3300,1956,-1344,-299,"16,3"
5998,77,"2,5",Waadt,1180,1700,1363,-337,-135,"17,7"
5999,72,"3,5",Waadt,1407,1550,1188,-362,-103,"16,5"
6000,103,"4,5",Basel-Landschaft,4123,2230,1700,-530,-118,"16,5"
6001,76,"3,5",Thurgau,8500,1457,1015,-442,-126,"13,35"
6001,76,"3,5",Zürich,8500,1457,1376,-81,-23,"18,1"
6009,63,"2,5",Waadt,1009,2250,1115,-1135,-454,"17,7"
6010,115,"4,5",Thurgau,9320,1890,1420,-470,-104,"12,35"
6020,105,"3,5",Thurgau,8555,2210,1402,-808,-231,"13,35"
6023,65,3,Waadt,1264,1850,1112,-738,-246,"17,1"
6024,91,4,Waadt,1264,2150,1447,-703,-176,"15,9"
6025,65,3,Waadt,1264,1850,1112,-738,-246,"17,1"
6026,80,"3,5",Waadt,1804,2000,1320,-680,-194,"16,5"
6027,65,2,Waadt,1860,1080,1190,110,55,"18,3"
6043,70,3,Solothurn,4114,1360,952,-408,-136,"13,6"
6054,88,"3,5",Bern,3123,1750,1258,-492,-141,"14,3"
6056,47,"2,5",Zürich,8400,1312,926,-386,-154,"19,7"
6058,95,"3,5",Zürich,8408,1753,1720,-33,-9,"18,1"
6059,88,"2,5",Thurgau,8272,1700,1245,-455,-182,"14,15"
6061,63,3,Luzern,6006,1515,970,-545,-182,"15,4"
6062,110,5,Solothurn,4114,1590,1419,-171,-34,"12,9"
6078,60,"3,5",Thurgau,8500,1169,801,-368,-105,"13,35"
6078,60,"3,5",Zürich,8500,1169,1086,-83,-24,"18,1"
6079,81,4,Zürich,8045,2850,1418,-1432,-358,"17,5"
6080,76,3,Basel-Stadt,4051,1763,1277,-486,-162,"16,8"
6081,65,"3,5",St. Gallen,9000,1270,900,-370,-106,"13,85"
6085,82,"3,5",Tessin,6816,1600,1107,-493,-141,"13,5"
6086,78,3,Zürich,8125,1850,1459,-391,-130,"18,7"
6087,54,"2,5",Luzern,6006,1430,869,-561,-224,"16,1"
6088,45,"2,5",Uri,6454,890,596,-294,-118,"13,25"
6089,91,"3,5",Luzern,6003,2200,1347,-853,-244,"14,8"
6092,92,"3,5",Aargau,5034,1900,1352,-548,-157,"14,7"
6093,140,6,Waadt,1147,4900,2422,-2478,-413,"17,3"
6094,119,"4,5",Waadt,1042,1960,1940,-20,-4,"16,3"
6095,135,"4,5",Basel-Landschaft,4052,1550,2228,678,151,"16,5"
6095,135,"4,5",Basel-Stadt,4052,1550,2295,745,166,17
6096,90,"3,5",Basel-Stadt,4051,1950,1508,-442,-126,"16,75"
6097,120,"4,5",Obwalden,6072,2400,1584,-816,-181,"13,2"
6102,95,"3,5",St. Gallen,9434,2030,1316,-714,-204,"13,85"
6110,107,"4,5",Schwyz,8845,1800,1675,-125,-28,"15,65"
6111,170,"3,5",St. Gallen,9615,1700,2355,655,187,"13,85"
6112,80,"3,5",Bern,2515,1625,1144,-481,-137,"14,3"
6114,85,"3,5",Schwyz,6410,1590,1373,-217,-62,"16,15"
6116,94,"4,5",Aargau,5085,1450,1340,-110,-24,"14,25"
6119,80,"4,5",Neuchâtel,2054,1500,996,-504,-112,"12,45"
6120,159,6,Luzern,6020,3150,2258,-892,-149,"14,2"
6121,60,3,St. Gallen,7323,1195,864,-331,-110,"14,4"
6122,80,"3,5",Bern,2515,1675,1144,-531,-152,"14,3"
6123,112,"3,5",Zürich,8477,2130,2027,-103,-29,"18,1"
6124,60,"3,5",Aargau,5332,990,882,-108,-31,"14,7"
6125,160,"5,5",Aargau,8967,3600,2264,-1336,-243,"14,15"
6127,75,"3,5",Aargau,5312,1300,1103,-197,-56,"14,7"
6129,117,5,Zug,6315,1850,2188,338,68,"18,7"
6129,117,5,Schwyz,6315,1850,1790,-60,-12,"15,3"
6130,90,"3,5",Aargau,5330,1495,1323,-172,-49,"14,7"
6131,112,"4,5",Solothurn,4616,2300,1445,-855,-190,"12,9"
6134,129,"4,5",Schwyz,8640,3950,2019,-1931,-429,"15,65"
6134,129,"4,5",St. Gallen,8640,3950,1683,-2267,-504,"13,05"
6135,80,"3,5",Bern,2515,1725,1144,-581,-166,"14,3"
6136,98,"4,5",Schwyz,6430,1790,1534,-256,-57,"15,65"
6137,121,"4,5",Jura,2800,2190,1246,-944,-210,"10,3"
6139,160,"5,5",Freiburg,1611,2500,2176,-324,-59,"13,6"
6140,160,"4,5",Aargau,4315,2300,2280,-20,-4,"14,25"
6141,126,"4,5",Obwalden,6064,2140,1663,-477,-106,"13,2"
6144,100,"4,5",Zürich,8053,1995,1755,-240,-53,"17,55"
6145,110,6,Aargau,5312,1500,1551,51,9,"14,1"
6146,79,"3,5",Zürich,8623,2040,1430,-610,-174,"18,1"
6149,90,"4,5",Basel-Stadt,4057,1900,1530,-370,-82,17
6150,80,"3,5",Waadt,1804,2000,1320,-680,-194,"16,5"
6151,27,1,Bern,3018,950,432,-518,-518,16
6155,91,4,Waadt,1264,2150,1447,-703,-176,"15,9"
6157,65,2,Waadt,1860,1080,1190,110,55,"18,3"
6158,65,3,Waadt,1264,1850,1112,-738,-246,"17,1"
6159,65,3,Waadt,1264,1850,1112,-738,-246,"17,1"
6160,116,"4,5",Tessin,6807,1700,1607,-93,-21,"13,85"
6162,30,2,Genf,1205,1350,564,-786,-393,"18,8"
6170,86,"3,5",St. Gallen,9602,1600,1191,-409,-117,"13,85"
6171,96,5,Graubünden,7000,1660,1171,-489,-98,"12,2"
6172,76,"3,5",Waadt,1110,1920,1254,-666,-190,"16,5"
6173,67,"2,5",Zürich,8427,1300,1320,20,8,"19,7"
6174,103,"3,5",Zürich,8050,3180,1864,-1316,-376,"18,1"
6176,68,"2,5",Bern,3018,1500,1010,-490,-196,"14,85"
6177,88,"3,5",Bern,3123,1750,1258,-492,-141,"14,3"
6178,120,"4,5",Aargau,4310,2450,1710,-740,-164,"14,25"
6180,92,"3,5",Wallis,1997,1350,1219,-131,-37,"13,25"
6181,92,"3,5",Wallis,1997,1100,1219,119,34,"13,25"
6182,85,"3,5",Appenzell Ausserrhoden,9042,1870,1084,-786,-225,"12,75"
6182,85,"3,5",St. Gallen,9042,1870,1177,-693,-198,"13,85"
6184,29,"1,5",Basel-Stadt,4057,1180,518,-662,-441,"17,85"
6185,73,"3,5",Schaffhausen,8200,1350,960,-390,-111,"13,15"
6186,98,"4,5",St. Gallen,9326,1780,1279,-501,-111,"13,05"
6186,98,"4,5",Thurgau,9326,1780,1210,-570,-127,"12,35"
6187,100,"4,5",St. Gallen,9212,1670,1305,-365,-81,"13,05"
6188,84,"3,5",Zürich,8212,1270,1520,250,71,"18,1"
6188,84,"3,5",Schaffhausen,8212,1270,1105,-165,-47,"13,15"
6189,67,"2,5",St. Gallen,9326,1260,998,-262,-105,"14,9"
6189,67,"2,5",Thurgau,9326,1260,948,-312,-125,"14,15"
6190,99,"4,5",St. Gallen,9200,1860,1292,-568,-126,"13,05"
6191,99,"4,5",St. Gallen,9200,1850,1292,-558,-124,"13,05"
6192,58,"2,5",Aargau,5600,1550,902,-648,-259,"15,55"
6193,52,"1,5",Aargau,5630,1895,840,-1055,-703,"16,15"
6194,57,"2,5",Aargau,5630,2065,886,-1179,-472,"15,55"
6195,90,"3,5",Aargau,5630,1910,1323,-587,-168,"14,7"
6197,100,"4,5",Zürich,8002,2300,1755,-545,-121,"17,55"
6199,105,"4,5",Luzern,6217,1590,1486,-104,-23,"14,15"
6200,111,"5,5",Luzern,6285,2060,1571,-489,-89,"14,15"
6203,78,"4,5",Schwyz,6414,1790,1221,-569,-126,"15,65"
6204,80,"3,5",Zürich,8620,1820,1448,-372,-106,"18,1"
6205,26,1,Basel-Stadt,4056,800,455,-345,-345,"17,5"
6206,83,4,Basel-Landschaft,4144,1790,1345,-445,-111,"16,2"
6208,27,1,Basel-Stadt,4057,710,473,-237,-237,"17,5"
6209,80,"3,5",St. Gallen,9205,1620,1108,-512,-146,"13,85"
6210,10,1,St. Gallen,9000,550,159,-391,-391,"15,9"
6211,101,4,St. Gallen,9008,1490,1343,-147,-37,"13,3"
6218,251,6,Bern,1595,3350,3389,39,7,"13,5"
6218,251,6,Waadt,1595,3350,4342,992,165,"17,3"
6223,75,"3,5",St. Gallen,8636,1169,1039,-130,-37,"13,85"
6223,75,"3,5",Zürich,8636,1169,1358,189,54,"18,1"
6224,73,"4,5",Bern,3075,1460,1011,-449,-100,"13,85"
6225,108,"3,5",Bern,3432,1690,1544,-146,-42,"14,3"
6229,95,"4,5",Bern,3063,2190,1316,-874,-194,"13,85"
6232,72,3,Bern,3027,1300,1044,-256,-85,"14,5"
6234,97,4,Bern,2553,1680,1368,-312,-78,"14,1"
6235,80,"3,5",Nidwalden,6370,1475,1272,-203,-58,"15,9"
6236,125,"4,5",Luzern,6012,2100,1769,-331,-74,"14,15"
6237,107,"4,5",Waadt,1400,2030,1744,-286,-64,"16,3"
6238,133,"4,5",Waadt,1350,2560,2168,-392,-87,"16,3"
6239,66,"2,5",Basel-Landschaft,4410,1280,1115,-165,-66,"16,9"
6240,25,1,Graubünden,7000,720,468,-252,-252,"18,7"
6241,108,"4,5",Zürich,8810,2420,1895,-525,-117,"17,55"
6244,29,"1,5",Solothurn,4563,750,389,-361,-241,"13,4"
6246,70,"3,5",Appenzell Ausserrhoden,9410,900,893,-7,-2,"12,75"
6251,68,3,Luzern,6006,1950,1047,-903,-301,"15,4"
6252,80,"4,5",Luzern,6003,1790,1132,-658,-146,"14,15"
6254,100,"4,5",Thurgau,8370,1850,1235,-615,-137,"12,35"
6260,120,4,St. Gallen,9400,1650,1596,-54,-14,"13,3"
6265,132,"4,5",Thurgau,9320,2290,1630,-660,-147,"12,35"
6266,120,6,St. Gallen,9125,1650,1476,-174,-29,"12,3"
6267,108,"5,5",Waadt,1260,2750,1836,-914,-166,17
6271,76,3,Bern,3018,2625,1102,-1523,-508,"14,5"
6274,80,"3,5",Zürich,8055,2590,1448,-1142,-326,"18,1"
6276,46,2,Zürich,8153,1550,952,-598,-299,"20,7"
6277,92,"3,5",Obwalden,6010,1990,1270,-720,-206,"13,8"
6277,92,"3,5",Nidwalden,6010,1990,1463,-527,-151,"15,9"
6277,92,"3,5",Luzern,6010,1990,1362,-628,-179,"14,8"
6291,78,"3,5",Zürich,8805,1680,1412,-268,-77,"18,1"
6292,12,"1,5",Basel-Stadt,4057,850,214,-636,-424,"17,85"
6293,11,"1,5",Basel-Stadt,4057,938,196,-742,-495,"17,85"
6294,19,1,Zürich,8052,1160,414,-746,-746,"21,8"
6295,70,"3,5",Bern,2502,1730,1001,-729,-208,"14,3"
6298,80,"3,5",Zürich,8154,1950,1448,-502,-143,"18,1"
6301,94,"3,5",St. Gallen,9444,1590,1302,-288,-82,"13,85"
6307,88,"3,5",Zürich,8038,3800,1593,-2207,-631,"18,1"
6308,70,3,Luzern,6005,1550,1078,-472,-157,"15,4"
6309,37,1,Bern,3013,1085,592,-493,-493,16
6310,107,"4,5",Bern,3400,2199,1482,-717,-159,"13,85"
6311,90,4,Zürich,8038,2980,1575,-1405,-351,"17,5"
6312,107,"4,5",Aargau,8956,2300,1525,-775,-172,"14,25"
6313,95,"3,5",Appenzell Ausserrhoden,9113,1500,1211,-289,-83,"12,75"
6313,95,"3,5",St. Gallen,9113,1500,1316,-184,-53,"13,85"
6314,120,4,St. Gallen,9400,1650,1596,-54,-14,"13,3"
6315,73,"3,5",Aargau,5454,1740,1073,-667,-191,"14,7"
6317,93,"4,5",Aargau,5454,1684,1325,-359,-80,"14,25"
6318,16,1,Zürich,8051,966,349,-617,-617,"21,8"
6322,79,"3,5",Aargau,5505,1700,1161,-539,-154,"14,7"
6323,67,"2,5",Aargau,4663,1465,1042,-423,-169,"15,55"
6323,67,"2,5",Solothurn,4663,1465,921,-544,-218,"13,75"
6324,65,"3,5",Zürich,8344,1320,1177,-143,-41,"18,1"
6325,110,"3,5",Waadt,1268,2650,1815,-835,-239,"16,5"
6327,58,2,Basel-Landschaft,4053,1450,992,-458,-229,"17,1"
6327,58,2,Basel-Stadt,4053,1450,1056,-394,-197,"18,2"
6328,60,"2,5",Glarus,8762,990,837,-153,-61,"13,95"
6329,89,"3,5",Bern,3014,1985,1273,-712,-203,"14,3"
6332,60,"2,5",Schwyz,6442,1150,1023,-127,-51,"17,05"
6333,81,"2,5",Zürich,8052,1880,1596,-284,-114,"19,7"
6354,44,"2,5",Wallis,3993,550,634,84,34,"14,4"
6355,84,3,Aargau,8965,1638,1268,-370,-123,"15,1"
6356,68,"3,5",Zürich,8630,1550,1231,-319,-91,"18,1"
6356,68,"3,5",St. Gallen,8630,1550,942,-608,-174,"13,85"
6357,46,2,Solothurn,4500,970,639,-331,-166,"13,9"
6359,74,"3,5",Luzern,6003,3700,1095,-2605,-744,"14,8"
6360,63,"2,5",Schaffhausen,8200,1190,904,-286,-114,"14,35"
6362,101,4,Basel-Landschaft,4464,1600,1636,36,9,"16,2"
6370,96,"3,5",Neuchâtel,2206,1440,1147,-293,-84,"11,95"
6371,90,"3,5",Neuchâtel,2206,1390,1076,-314,-90,"11,95"
6375,120,"4,5",Freiburg,1580,1650,1620,-30,-7,"13,5"
6375,120,"4,5",Waadt,1580,1650,1956,306,68,"16,3"
6377,46,"2,5",Nidwalden,6390,1168,766,-402,-161,"16,65"
6377,46,"2,5",Obwalden,6390,1168,658,-510,-204,"14,3"
6377,46,"2,5",Uri,6390,1168,610,-558,-223,"13,25"
6378,80,3,St. Gallen,9000,1260,1152,-108,-36,"14,4"
6379,58,3,Thurgau,9500,1180,806,-374,-125,"13,9"
6379,58,3,St. Gallen,9500,1180,835,-345,-115,"14,4"
6380,48,2,Basel-Landschaft,4147,1115,821,-294,-147,"17,1"
6381,69,"3,5",Thurgau,8280,1275,921,-354,-101,"13,35"
6383,44,"2,5",Solothurn,2540,770,605,-165,-66,"13,75"
6384,100,"3,5",Basel-Landschaft,4242,1640,1645,5,1,"16,45"
6385,99,"4,5",Basel-Stadt,4051,2770,1683,-1087,-242,17
6387,111,"5,5",St. Gallen,9014,1580,1393,-187,-34,"12,55"
6387,111,"5,5",Appenzell Ausserrhoden,9014,1580,1254,-326,-59,"11,3"
6390,62,"2,5",Zürich,8942,2400,1221,-1179,-472,"19,7"
6392,102,"4,5",Zürich,8942,2955,1790,-1165,-259,"17,55"
6393,75,"3,5",Zürich,8942,2175,1358,-817,-233,"18,1"
6396,140,"5,5",Thurgau,8570,1800,1659,-141,-26,"11,85"
6402,71,"3,5",Appenzell Ausserrhoden,9012,1450,905,-545,-156,"12,75"
6402,71,"3,5",St. Gallen,9012,1450,983,-467,-133,"13,85"
6403,71,"3,5",Appenzell Ausserrhoden,9012,1450,905,-545,-156,"12,75"
6403,71,"3,5",St. Gallen,9012,1450,983,-467,-133,"13,85"
6404,29,1,Appenzell Ausserrhoden,9012,720,479,-241,-241,"16,5"
6404,29,1,St. Gallen,9012,720,461,-259,-259,"15,9"
6405,52,"1,5",Appenzell Ausserrhoden,9012,975,819,-156,-104,"15,75"
6405,52,"1,5",St. Gallen,9012,975,814,-161,-107,"15,65"
6406,48,"1,5",Appenzell Ausserrhoden,9012,950,756,-194,-129,"15,75"
6406,48,"1,5",St. Gallen,9012,950,751,-199,-133,"15,65"
6417,84,"3,5",Bern,3860,1300,1201,-99,-28,"14,3"
6420,140,"5,5",Uri,6467,2300,1792,-508,-92,"12,8"
6422,79,"2,5",Appenzell Ausserrhoden,9038,1200,1098,-102,-41,"13,9"
6426,62,"2,5",Zürich,8942,2400,1221,-1179,-472,"19,7"
6427,200,"5,5",St. Gallen,7310,2700,2510,-190,-35,"12,55"
6428,85,3,Zürich,8038,2498,1590,-908,-303,"18,7"
6429,89,"4,5",Zürich,8620,1684,1562,-122,-27,"17,55"
6430,47,2,Aargau,5070,1200,752,-448,-224,16
6431,80,"3,5",Aargau,4324,1190,1176,-14,-4,"14,7"
6432,90,4,Aargau,4313,1580,1287,-293,-73,"14,3"
6433,114,"2,5",Aargau,4313,1980,1773,-207,-83,"15,55"
6434,98,"4,5",Aargau,5073,1610,1397,-213,-47,"14,25"
6435,81,"3,5",Aargau,4317,1070,1191,121,35,"14,7"
6436,70,3,Aargau,5070,1460,1057,-403,-134,"15,1"
6437,70,"3,5",Schwyz,6430,1420,1131,-289,-83,"16,15"
6439,50,"2,5",Graubünden,7503,1650,793,-857,-343,"15,85"
6440,180,"5,5",Graubünden,7205,2480,2169,-311,-57,"12,05"
6441,116,"4,5",Zug,6343,2380,2175,-205,-46,"18,75"
6445,100,"3,5",Thurgau,8570,1790,1335,-455,-130,"13,35"
6448,93,"4,5",St. Gallen,9326,1690,1214,-476,-106,"13,05"
6448,93,"4,5",Thurgau,9326,1690,1149,-541,-120,"12,35"
6449,55,"2,5",Wallis,1950,1500,792,-708,-283,"14,4"
6451,116,"5,5",Zürich,8610,2200,2071,-129,-23,"17,85"
6452,53,"2,5",Graubünden,7270,1500,840,-660,-264,"15,85"
6453,89,"3,5",Bern,3014,1985,1273,-712,-203,"14,3"
6458,63,"2,5",Schaffhausen,8200,1190,904,-286,-114,"14,35"
6459,160,5,St. Gallen,8716,2650,2048,-602,-120,"12,8"
6461,82,"3,5",Basel-Landschaft,4103,1820,1349,-471,-135,"16,45"
6463,150,"3,5",Aargau,5057,1900,2205,305,87,"14,7"
6466,76,"3,5",Appenzell Innerrhoden,9050,1345,1064,-281,-80,14
6467,53,"1,5",Waadt,1530,980,1049,69,46,"19,8"
6469,116,"3,5",Solothurn,4528,1875,1537,-338,-97,"13,25"
6486,45,2,St. Gallen,9100,780,693,-87,-44,"15,4"
6486,45,2,Appenzell Ausserrhoden,9100,780,675,-105,-53,15
6488,90,3,Thurgau,8274,1550,1251,-299,-100,"13,9"
6489,85,4,St. Gallen,9000,1580,1131,-449,-112,"13,3"
6490,83,"3,5",Solothurn,4143,1735,1100,-635,-181,"13,25"
6493,45,"2,5",Bern,3400,1010,668,-342,-137,"14,85"
6495,54,2,Genf,1224,2800,1015,-1785,-893,"18,8"
6496,92,4,Waadt,1267,2080,1463,-617,-154,"15,9"
6498,75,"3,5",Luzern,6217,1490,1110,-380,-109,"14,8"
6499,120,"4,5",Waadt,1326,2030,1956,-74,-16,"16,3"
6500,76,3,Waadt,1892,1250,1300,50,17,"17,1"
6503,120,6,Thurgau,9213,1720,1416,-304,-51,"11,8"
6503,120,6,St. Gallen,9213,1720,1476,-244,-41,"12,3"
6506,100,"4,5",Thurgau,8370,1850,1235,-615,-137,"12,35"
6507,80,"4,5",St. Gallen,9000,1490,1044,-446,-99,"13,05"
6509,106,6,Zürich,8472,2300,1919,-381,-64,"18,1"
6511,40,1,Genf,1223,2950,788,-2162,-2162,"19,7"
6512,146,"5,5",Waadt,1450,2250,2482,232,42,17
6513,160,3,Basel-Stadt,4051,2950,2688,-262,-87,"16,8"
6514,100,"4,5",Bern,2543,1600,1385,-215,-48,"13,85"
6515,40,"2,5",Wallis,3911,740,576,-164,-66,"14,4"
6517,74,"3,5",St. Gallen,7320,1900,1025,-875,-250,"13,85"
6520,140,"4,5",Waadt,1302,2565,2282,-283,-63,"16,3"
6522,126,4,Neuchâtel,2034,2302,1537,-765,-191,"12,2"
6524,140,"4,5",Nidwalden,6376,2080,2100,20,4,15
6528,115,"4,5",Schwyz,8730,1990,1800,-190,-42,"15,65"
6528,115,"4,5",St. Gallen,8730,1990,1501,-489,-109,"13,05"
6529,168,"4,5",Tessin,6573,2400,2327,-73,-16,"13,85"
6530,90,"3,5",Waadt,1261,1850,1485,-365,-104,"16,5"
6531,200,"5,5",Zürich,8805,3630,3570,-60,-11,"17,85"
6532,100,"3,5",Luzern,6030,1700,1480,-220,-63,"14,8"
6536,129,"3,5",Luzern,6353,3900,1909,-1991,-569,"14,8"
6537,81,"3,5",St. Gallen,9000,1400,1122,-278,-79,"13,85"
6538,74,"3,5",St. Gallen,7320,1900,1025,-875,-250,"13,85"
6540,88,"3,5",St. Gallen,9000,1780,1219,-561,-160,"13,85"
6542,60,"3,5",Aargau,5512,1150,882,-268,-77,"14,7"
6543,106,"4,5",Appenzell Ausserrhoden,9055,1700,1299,-401,-89,"12,25"
6543,106,"4,5",Appenzell Innerrhoden,9055,1700,1357,-343,-76,"12,8"
6546,100,"3,5",Bern,2543,1550,1430,-120,-34,"14,3"
6547,111,"4,5",St. Gallen,9437,2200,1449,-751,-167,"13,05"
6547,111,"4,5",Appenzell Ausserrhoden,9437,2200,1360,-840,-187,"12,25"
6548,94,"3,5",Aargau,5603,1850,1382,-468,-134,"14,7"
6550,80,"4,5",Aargau,5210,1600,1140,-460,-102,"14,25"
6553,126,"5,5",Zürich,8344,2190,2249,59,11,"17,85"
6554,115,"4,5",Schwyz,6402,2840,1800,-1040,-231,"15,65"
6555,55,"2,5",Wallis,1907,800,792,-8,-3,"14,4"
6556,106,"4,5",Appenzell Ausserrhoden,9055,1700,1299,-401,-89,"12,25"
6556,106,"4,5",Appenzell Innerrhoden,9055,1700,1357,-343,-76,"12,8"
6560,122,"4,5",Aargau,5617,1785,1739,-46,-10,"14,25"
6561,102,"3,5",Appenzell Ausserrhoden,9055,1550,1301,-249,-71,"12,75"
6561,102,"3,5",Appenzell Innerrhoden,9055,1550,1428,-122,-35,14
6562,112,"3,5",Aargau,5606,1430,1646,216,62,"14,7"
6563,124,"3,5",Aargau,5453,1760,1823,63,18,"14,7"
6564,110,"5,5",Zürich,8112,2370,1964,-406,-74,"17,85"
6565,82,4,St. Gallen,9000,1350,1091,-259,-65,"13,3"
6568,126,"4,5",St. Gallen,7320,2975,1644,-1331,-296,"13,05"
6569,130,"4,5",Bern,4716,1690,1801,111,25,"13,85"
6569,130,"4,5",Solothurn,4716,1690,1677,-13,-3,"12,9"
6572,70,"2,5",Aargau,8962,1790,1089,-701,-280,"15,55"
6574,115,"4,5",Zürich,8630,2400,2018,-382,-85,"17,55"
6574,115,"4,5",St. Gallen,8630,2400,1501,-899,-200,"13,05"
6575,74,"3,5",Wallis,3960,1290,981,-309,-88,"13,25"
6576,63,"2,5",Wallis,1950,1070,907,-163,-65,"14,4"
6579,93,"4,5",Aargau,5035,1690,1325,-365,-81,"14,25"
6580,135,"5,5",Zürich,8400,2980,2410,-570,-104,"17,85"
6581,67,"2,5",Zürich,8700,1950,1320,-630,-252,"19,7"
6582,69,"3,5",Basel-Landschaft,4133,1665,1135,-530,-151,"16,45"
6583,39,2,Waadt,1804,1115,714,-401,-201,"18,3"
6585,50,"2,5",Wallis,3960,1060,720,-340,-136,"14,4"
6586,69,"3,5",Basel-Landschaft,4123,1640,1135,-505,-144,"16,45"
6587,57,2,Waadt,1022,1395,1043,-352,-176,"18,3"
6588,57,"2,5",St. Gallen,9620,1010,849,-161,-64,"14,9"
6589,121,"4,5",Waadt,1003,2990,1972,-1018,-226,"16,3"
6590,73,"2,5",Waadt,1305,1730,1292,-438,-175,"17,7"
6592,50,"1,5",Basel-Landschaft,4416,995,853,-142,-95,"17,05"
6593,56,"2,5",Basel-Landschaft,4142,1370,946,-424,-170,"16,9"
6594,119,"4,5",Basel-Landschaft,4123,2390,1964,-426,-95,"16,5"
6595,53,2,Basel-Landschaft,4053,1450,906,-544,-272,"17,1"
6595,53,2,Basel-Stadt,4053,1450,965,-485,-243,"18,2"
6596,70,"2,5",Luzern,6023,1560,1127,-433,-173,"16,1"
6597,70,3,Luzern,6210,1365,1078,-287,-96,"15,4"
6600,61,3,Solothurn,4500,1190,830,-360,-120,"13,6"
6601,76,"2,5",St. Gallen,7310,1660,1132,-528,-211,"14,9"
6604,61,3,Waadt,1018,1750,1043,-707,-236,"17,1"
6605,230,"5,5",Waadt,1815,3800,3910,110,20,17
6606,87,"3,5",Waadt,1522,2030,1436,-594,-170,"16,5"
6607,86,"3,5",Waadt,1180,2520,1419,-1101,-315,"16,5"
6608,85,"3,5",Waadt,1180,2680,1403,-1277,-365,"16,5"
6609,61,"2,5",Zürich,8057,1900,1202,-698,-279,"19,7"
6617,50,"2,5",Freiburg,1635,1230,763,-467,-187,"15,25"
6618,152,5,Waadt,1110,4900,2538,-2362,-472,"16,7"
6620,48,2,Zürich,8051,1560,994,-566,-283,"20,7"
6621,67,"3,5",Zürich,8050,2390,1213,-1177,-336,"18,1"
6622,109,"3,5",St. Gallen,9443,2190,1510,-680,-194,"13,85"
6623,86,"3,5",Basel-Landschaft,4153,2020,1415,-605,-173,"16,45"
6624,65,"2,5",Basel-Landschaft,4107,1380,1099,-281,-112,"16,9"
6625,63,2,Basel-Stadt,4057,1420,1147,-273,-137,"18,2"
6626,87,"3,5",Thurgau,9320,1200,1161,-39,-11,"13,35"
6627,89,"3,5",Thurgau,9320,1235,1188,-47,-13,"13,35"
6628,52,"2,5",St. Gallen,7310,1335,775,-560,-224,"14,9"
6629,105,"4,5",Thurgau,8500,1790,1297,-493,-110,"12,35"
6629,105,"4,5",Zürich,8500,1790,1843,53,12,"17,55"
6631,63,"2,5",Luzern,6006,2350,1014,-1336,-534,"16,1"
6632,97,"2,5",Zürich,8003,3368,1911,-1457,-583,"19,7"
6633,91,"3,5",Thurgau,8570,1340,1215,-125,-36,"13,35"
6634,65,"2,5",Graubünden,7270,1360,1030,-330,-132,"15,85"
6636,65,"2,5",Graubünden,7270,1350,1030,-320,-128,"15,85"
6638,54,2,Genf,1224,2800,1015,-1785,-893,"18,8"
6643,65,3,Waadt,1020,1655,1112,-543,-181,"17,1"
6644,97,"3,5",Waadt,1092,1910,1601,-309,-88,"16,5"
6646,126,"4,5",St. Gallen,9000,2600,1644,-956,-212,"13,05"
6648,64,"3,5",Appenzell Innerrhoden,9450,1590,896,-694,-198,14
6648,64,"3,5",Appenzell Ausserrhoden,9450,1590,816,-774,-221,"12,75"
6648,64,"3,5",St. Gallen,9450,1590,886,-704,-201,"13,85"
6649,95,"4,5",St. Gallen,9403,1560,1240,-320,-71,"13,05"
6652,56,"2,5",St. Gallen,9230,1290,834,-456,-182,"14,9"
6653,84,"3,5",Appenzell Innerrhoden,9450,1620,1176,-444,-127,14
6653,84,"3,5",Appenzell Ausserrhoden,9450,1620,1071,-549,-157,"12,75"
6653,84,"3,5",St. Gallen,9450,1620,1163,-457,-131,"13,85"
6654,82,"3,5",St. Gallen,9008,1850,1136,-714,-204,"13,85"
6655,47,"2,5",St. Gallen,9230,1240,700,-540,-216,"14,9"
6656,84,"3,5",Appenzell Innerrhoden,9450,1440,1176,-264,-75,14
6656,84,"3,5",Appenzell Ausserrhoden,9450,1440,1071,-369,-105,"12,75"
6656,84,"3,5",St. Gallen,9450,1440,1163,-277,-79,"13,85"
6657,51,"2,5",Appenzell Innerrhoden,9450,1250,668,-582,-233,"13,1"
6657,51,"2,5",Appenzell Ausserrhoden,9450,1250,709,-541,-216,"13,9"
6657,51,"2,5",St. Gallen,9450,1250,760,-490,-196,"14,9"
6658,33,"1,5",St. Gallen,9230,650,516,-134,-89,"15,65"
6659,73,"3,5",St. Gallen,9436,1550,1011,-539,-154,"13,85"
6660,60,3,St. Gallen,9000,1250,864,-386,-129,"14,4"
6661,39,"1,5",Thurgau,8583,940,550,-390,-260,"14,1"
6662,35,"1,5",St. Gallen,9400,870,548,-322,-215,"15,65"
6663,60,3,St. Gallen,9000,1200,864,-336,-112,"14,4"
6664,72,"1,5",Thurgau,8269,1650,1015,-635,-423,"14,1"
6665,87,"3,5",St. Gallen,9436,1730,1205,-525,-150,"13,85"
6666,55,3,St. Gallen,9552,1140,792,-348,-116,"14,4"
6667,64,"2,5",St. Gallen,9400,1295,954,-341,-136,"14,9"
6668,25,1,St. Gallen,9000,770,398,-372,-372,"15,9"
6669,90,"3,5",St. Gallen,9404,1690,1247,-443,-127,"13,85"
6670,95,"3,5",St. Gallen,9430,1690,1316,-374,-107,"13,85"
6672,90,"3,5",St. Gallen,9400,1720,1247,-473,-135,"13,85"
6674,83,"3,5",St. Gallen,9008,1870,1150,-720,-206,"13,85"
6675,95,"3,5",St. Gallen,9430,1640,1316,-324,-93,"13,85"
6676,79,"3,5",Thurgau,8269,1680,1055,-625,-179,"13,35"
6677,74,"3,5",St. Gallen,9300,1160,1025,-135,-39,"13,85"
6680,73,"2,5",Thurgau,8269,1730,1033,-697,-279,"14,15"
6681,55,"2,5",Appenzell Innerrhoden,9450,1240,721,-519,-208,"13,1"
6681,55,"2,5",Appenzell Ausserrhoden,9450,1240,765,-475,-190,"13,9"
6681,55,"2,5",St. Gallen,9450,1240,820,-420,-168,"14,9"
6682,60,3,St. Gallen,9000,1170,864,-306,-102,"14,4"
6685,45,2,St. Gallen,9404,770,693,-77,-39,"15,4"
6692,55,"2,5",Zürich,8630,1260,1084,-176,-70,"19,7"
6692,55,"2,5",St. Gallen,8630,1260,820,-440,-176,"14,9"
6694,90,"4,5",Schaffhausen,8207,1420,1175,-245,-54,"13,05"
6695,43,1,Basel-Landschaft,4053,1005,731,-274,-274,17
6695,43,1,Basel-Stadt,4053,1005,753,-252,-252,"17,5"
6696,96,"4,5",Aargau,4663,1855,1368,-487,-108,"14,25"
6696,96,"4,5",Solothurn,4663,1855,1238,-617,-137,"12,9"
6697,64,"2,5",Freiburg,1630,1375,976,-399,-160,"15,25"
6698,102,"5,5",St. Gallen,9016,1910,1280,-630,-115,"12,55"
6699,45,2,Neuchâtel,2000,1180,567,-613,-307,"12,6"
6701,68,3,Waadt,1018,1600,1163,-437,-146,"17,1"
6704,108,"5,5",Waadt,1260,2750,1836,-914,-166,17
6708,60,"3,5",Tessin,6900,1150,810,-340,-97,"13,5"
6710,44,2,Bern,3775,840,669,-171,-86,"15,2"
6712,92,"3,5",St. Gallen,9469,1590,1274,-316,-90,"13,85"
6713,81,4,Genf,1248,2900,1466,-1434,-359,"18,1"
6714,44,2,Bern,3775,940,669,-271,-136,"15,2"
6715,65,"3,5",Bern,3775,1080,930,-150,-43,"14,3"
6716,97,"3,5",Zürich,8952,2383,1756,-627,-179,"18,1"
6717,55,"2,5",Thurgau,8280,900,778,-122,-49,"14,15"
6718,80,"3,5",Zürich,8620,1820,1448,-372,-106,"18,1"
6720,115,"4,5",Zürich,8105,2790,2018,-772,-172,"17,55"
6721,80,4,Appenzell Ausserrhoden,9012,1390,1016,-374,-94,"12,7"
6721,80,4,St. Gallen,9012,1390,1064,-326,-82,"13,3"
6722,53,2,Schwyz,8840,875,943,68,34,"17,8"
6725,81,4,Basel-Stadt,4057,1810,1353,-457,-114,"16,7"
6728,49,"2,5",Bern,3006,1450,728,-722,-289,"14,85"
6730,36,2,Basel-Landschaft,4133,940,616,-324,-162,"17,1"
6731,140,"4,5",Waadt,1041,1850,2282,432,96,"16,3"
6736,102,"3,5",Wallis,1967,1100,1352,252,72,"13,25"
6739,77,"3,5",Basel-Landschaft,4410,1690,1267,-423,-121,"16,45"
6740,73,"3,5",Basel-Landschaft,4133,1530,1201,-329,-94,"16,45"
6742,112,4,Tessin,6900,1750,1512,-238,-60,"13,5"
6743,85,"2,5",Tessin,6900,1250,1135,-115,-46,"13,35"
6744,82,"3,5",Freiburg,3175,1575,1160,-415,-119,"14,15"
6748,55,"1,5",Obwalden,6010,1430,839,-591,-394,"15,25"
6748,55,"1,5",Nidwalden,6010,1430,858,-572,-381,"15,6"
6748,55,"1,5",Luzern,6010,1430,979,-451,-301,"17,8"
6750,62,3,Zürich,8400,1490,1159,-331,-110,"18,7"
6751,50,"2,5",Tessin,6900,1120,668,-452,-181,"13,35"
6752,60,"3,5",Tessin,6900,1220,810,-410,-117,"13,5"
6753,50,"2,5",Tessin,6900,1170,668,-502,-201,"13,35"
6754,101,"4,5",Basel-Landschaft,4242,1985,1667,-318,-71,"16,5"
6755,85,"3,5",Zürich,8008,4690,1539,-3151,-900,"18,1"
6756,68,"3,5",Bern,3027,1320,972,-348,-99,"14,3"
6759,94,"3,5",Obwalden,6010,2290,1297,-993,-284,"13,8"
6759,94,"3,5",Nidwalden,6010,2290,1495,-795,-227,"15,9"
6759,94,"3,5",Luzern,6010,2290,1391,-899,-257,"14,8"
6760,128,"4,5",Schwyz,8835,2950,2003,-947,-210,"15,65"
6761,89,"3,5",Uri,6460,1750,1144,-606,-173,"12,85"
6763,81,"3,5",Luzern,6020,1650,1199,-451,-129,"14,8"
6764,70,3,Zürich,8708,1850,1309,-541,-180,"18,7"
6765,90,"3,5",Zürich,8932,1900,1629,-271,-77,"18,1"
6766,101,"4,5",Obwalden,6010,1820,1333,-487,-108,"13,2"
6766,101,"4,5",Nidwalden,6010,1820,1515,-305,-68,15
6766,101,"4,5",Luzern,6010,1820,1429,-391,-87,"14,15"
6771,78,4,Zug,6312,1840,1466,-374,-94,"18,8"
6773,54,"2,5",Basel-Landschaft,4460,1380,913,-467,-187,"16,9"
6774,51,2,Basel-Landschaft,4053,1430,872,-558,-279,"17,1"
6774,51,2,Basel-Stadt,4053,1430,928,-502,-251,"18,2"
6777,60,3,Basel-Stadt,4055,1394,1008,-386,-129,"16,8"
6778,90,"3,5",Tessin,6963,1550,1215,-335,-96,"13,5"
6779,55,"2,5",Tessin,6976,1400,734,-666,-266,"13,35"
6782,80,"2,5",Tessin,6817,1500,1068,-432,-173,"13,35"
6783,130,"4,5",Tessin,6963,1750,1801,51,11,"13,85"
6784,98,"2,5",Tessin,6982,1400,1308,-92,-37,"13,35"
6785,64,3,Luzern,6005,1220,986,-234,-78,"15,4"
6786,30,1,Basel-Stadt,4051,1100,525,-575,-575,"17,5"
6787,143,"5,5",Schwyz,6438,2480,2324,-156,-28,"16,25"
6788,100,"4,5",Aargau,4665,1430,1425,-5,-1,"14,25"
6790,65,"2,5",Aargau,5525,1340,1011,-329,-132,"15,55"
6791,118,"3,5",Graubünden,7214,1680,1776,96,27,"15,05"
6794,72,3,Genf,1205,2650,1332,-1318,-439,"18,5"
6795,83,"3,5",Zürich,8008,2890,1502,-1388,-397,"18,1"
6796,89,4,Zürich,8047,1790,1558,-232,-58,"17,5"
6797,81,4,Genf,1202,2790,1466,-1324,-331,"18,1"
6798,68,4,Genf,1219,2190,1231,-959,-240,"18,1"
6800,115,"5,5",Zürich,8302,2217,2053,-164,-30,"17,85"
6801,17,1,Luzern,6003,1690,320,-1370,-1370,"18,8"
6802,50,"2,5",Thurgau,8280,1400,708,-692,-277,"14,15"
6803,101,"4,5",St. Gallen,9230,1460,1318,-142,-32,"13,05"
6804,71,"2,5",Luzern,6006,1695,1143,-552,-221,"16,1"
6805,80,3,Luzern,6210,1600,1232,-368,-123,"15,4"
6806,67,"3,5",Luzern,6020,1390,992,-398,-114,"14,8"
6807,30,1,Luzern,6004,1020,564,-456,-456,"18,8"
6808,73,"2,5",Zürich,8005,2620,1438,-1182,-473,"19,7"
6809,50,2,Luzern,6004,1435,840,-595,-298,"16,8"
6810,62,"2,5",Appenzell Innerrhoden,9450,1360,812,-548,-219,"13,1"
6810,62,"2,5",Appenzell Ausserrhoden,9450,1360,862,-498,-199,"13,9"
6810,62,"2,5",St. Gallen,9450,1360,924,-436,-174,"14,9"
6811,66,3,Solothurn,4528,1170,898,-272,-91,"13,6"
6812,58,3,Luzern,6015,1190,893,-297,-99,"15,4"
6813,95,"3,5",Aargau,5420,1790,1397,-393,-112,"14,7"
6814,75,3,Waadt,1020,1830,1283,-547,-182,"17,1"
6815,34,1,Zürich,8057,1222,741,-481,-481,"21,8"
6816,93,"2,5",Aargau,5423,1630,1446,-184,-74,"15,55"
6821,78,3,Zürich,8008,3300,1459,-1841,-614,"18,7"
6825,85,"4,5",Genf,1202,3000,1556,-1444,-321,"18,3"
6828,57,"2,5",Zürich,8032,2600,1123,-1477,-591,"19,7"
6829,70,"3,5",Schwyz,6440,1530,1131,-399,-114,"16,15"
6832,35,"1,5",Zürich,8008,1990,744,-1246,-831,"21,25"
6833,124,"4,5",St. Gallen,9620,1950,1618,-332,-74,"13,05"
6834,85,"3,5",St. Gallen,9630,1280,1177,-103,-29,"13,85"
6836,87,"4,5",St. Gallen,9630,1130,1135,5,1,"13,05"
6837,80,"3,5",Zürich,8002,3600,1448,-2152,-615,"18,1"
6840,100,"4,5",Aargau,8967,1812,1425,-387,-86,"14,25"
6841,101,4,Aargau,5605,1720,1444,-276,-69,"14,3"
6844,68,"3,5",Freiburg,1470,1370,962,-408,-117,"14,15"
6845,131,"3,5",Luzern,6005,3870,1939,-1931,-552,"14,8"
6846,133,"4,5",Schwyz,8730,1980,2081,101,22,"15,65"
6846,133,"4,5",St. Gallen,8730,1980,1736,-244,-54,"13,05"
6849,76,"3,5",Zürich,8126,1860,1376,-484,-138,"18,1"
6850,61,"2,5",Zürich,8008,2990,1202,-1788,-715,"19,7"
6851,63,2,Basel-Stadt,4057,1420,1147,-273,-137,"18,2"
6852,34,"1,5",Basel-Stadt,4055,1000,607,-393,-262,"17,85"
6853,54,2,Basel-Stadt,4055,1150,983,-167,-84,"18,2"
6854,53,"2,5",Zürich,8008,2500,1044,-1456,-582,"19,7"
6855,92,4,Waadt,1020,2050,1463,-587,-147,"15,9"
6856,85,"3,5",Zürich,8008,3600,1539,-2061,-589,"18,1"
6858,31,1,Zürich,8400,1390,676,-714,-714,"21,8"
6860,79,"3,5",Aargau,5505,1700,1161,-539,-154,"14,7"
6862,91,"3,5",Luzern,6048,2590,1347,-1243,-355,"14,8"
6863,162,6,Genf,1206,5450,3661,-1789,-298,"22,6"
6865,80,"4,5",Schaffhausen,8200,1490,1044,-446,-99,"13,05"
6866,132,"3,5",Schaffhausen,8200,2000,1736,-264,-75,"13,15"
6867,80,"3,5",Zürich,8902,1980,1448,-532,-152,"18,1"
6869,135,"5,5",Zürich,8404,2790,2410,-380,-69,"17,85"
6870,150,"5,5",Waadt,1806,4290,2550,-1740,-316,17
6872,120,"4,5",Freiburg,1580,1650,1620,-30,-7,"13,5"
6872,120,"4,5",Waadt,1580,1650,1956,306,68,"16,3"
6873,57,"1,5",Thurgau,8575,1120,804,-316,-211,"14,1"
6874,89,"3,5",Zürich,8153,1990,1611,-379,-108,"18,1"
6876,83,"3,5",St. Gallen,9000,1510,1150,-360,-103,"13,85"
6877,70,4,Obwalden,6010,1590,952,-638,-160,"13,6"
6877,70,4,Nidwalden,6010,1590,1057,-533,-133,"15,1"
6877,70,4,Luzern,6010,1590,994,-596,-149,"14,2"
6878,136,"5,5",Aargau,5210,2570,1924,-646,-117,"14,15"
6879,123,"4,5",Schwyz,8853,2500,1925,-575,-128,"15,65"
6880,62,"2,5",Solothurn,4600,1360,853,-507,-203,"13,75"
6880,62,"2,5",Aargau,4600,1360,964,-396,-158,"15,55"
6881,33,1,Waadt,1003,900,703,-197,-197,"21,3"
6884,120,"4,5",Aargau,4323,2400,1710,-690,-153,"14,25"
6886,228,"4,5",Zürich,8704,6490,4001,-2489,-553,"17,55"
6887,110,"4,5",Aargau,5037,1860,1568,-292,-65,"14,25"
6888,110,"4,5",Aargau,5037,1800,1568,-232,-52,"14,25"
6890,85,"2,5",Zürich,8008,3300,1675,-1625,-650,"19,7"
6891,70,3,St. Gallen,9323,1145,1008,-137,-46,"14,4"
6892,81,"3,5",Obwalden,6010,2050,1118,-932,-266,"13,8"
6892,81,"3,5",Nidwalden,6010,2050,1288,-762,-218,"15,9"
6892,81,"3,5",Luzern,6010,2050,1199,-851,-243,"14,8"
6893,117,"4,5",Luzern,6006,2450,1656,-794,-176,"14,15"
6894,60,"2,5",Zürich,8008,2800,1182,-1618,-647,"19,7"
6897,60,"3,5",Solothurn,4554,1150,795,-355,-101,"13,25"
6898,110,"3,5",Solothurn,4554,1510,1458,-52,-15,"13,25"
6900,75,4,Zürich,8184,1390,1313,-77,-19,"17,5"
6901,120,"5,5",St. Gallen,9000,2040,1506,-534,-97,"12,55"
6902,69,"2,5",Waadt,1510,1345,1221,-124,-50,"17,7"
6903,89,"3,5",Zürich,8623,1590,1611,21,6,"18,1"
6905,90,"3,5",Bern,3013,1955,1287,-668,-191,"14,3"
6907,123,"4,5",Aargau,5036,2350,1753,-597,-133,"14,25"
6911,100,"4,5",Zürich,8108,2080,1755,-325,-72,"17,55"
6915,53,"1,5",Waadt,1530,980,1049,69,46,"19,8"
6916,116,"3,5",Solothurn,4528,1875,1537,-338,-97,"13,25"
6917,100,"3,5",Uri,6454,1800,1285,-515,-147,"12,85"
6919,17,1,Luzern,6003,490,320,-170,-170,"18,8"
6921,120,4,St. Gallen,9400,1650,1596,-54,-14,"13,3"
6922,95,"3,5",Appenzell Ausserrhoden,9113,1500,1211,-289,-83,"12,75"
6922,95,"3,5",St. Gallen,9113,1500,1316,-184,-53,"13,85"
6923,73,"3,5",Aargau,5454,1740,1073,-667,-191,"14,7"
6927,93,"4,5",Aargau,5454,1684,1325,-359,-80,"14,25"
6931,146,"4,5",Zürich,8048,3750,2562,-1188,-264,"17,55"
6932,58,"2,5",Obwalden,6060,880,829,-51,-20,"14,3"
6933,100,"3,5",Aargau,5406,1880,1470,-410,-117,"14,7"
6938,16,1,Zürich,8051,966,349,-617,-617,"21,8"
6939,65,"2,5",Thurgau,8590,1720,920,-800,-320,"14,15"
6940,60,3,Zürich,8408,1570,1122,-448,-149,"18,7"
6941,106,"4,5",Luzern,6003,3120,1500,-1620,-360,"14,15"
6945,113,"3,5",Bern,3303,1980,1616,-364,-104,"14,3"
6947,85,"3,5",Freiburg,1475,1440,1203,-237,-68,"14,15"
6949,70,3,Wallis,3961,1300,973,-327,-109,"13,9"
6951,81,"4,5",Neuchâtel,2300,1170,1008,-162,-36,"12,45"
6955,65,"3,5",Schwyz,8750,1240,1050,-190,-54,"16,15"
6955,65,"3,5",Glarus,8750,1240,826,-414,-118,"12,7"
6958,75,"5,5",Zürich,8052,2975,1339,-1636,-297,"17,85"
6962,73,"2,5",Appenzell Innerrhoden,9052,1790,956,-834,-334,"13,1"
6962,73,"2,5",Appenzell Ausserrhoden,9052,1790,1015,-775,-310,"13,9"
6963,132,"4,5",Thurgau,9320,2290,1630,-660,-147,"12,35"
6965,120,"4,5",Thurgau,9517,1690,1482,-208,-46,"12,35"
6972,81,3,Thurgau,9315,1575,1126,-449,-150,"13,9"
6972,81,3,St. Gallen,9315,1575,1166,-409,-136,"14,4"
6973,32,"1,5",Bern,3006,1116,499,-617,-411,"15,6"
6974,92,4,Waadt,1267,2080,1463,-617,-154,"15,9"
6976,76,3,Waadt,1892,1250,1300,50,17,"17,1"
6977,120,"4,5",Waadt,1326,2030,1956,-74,-16,"16,3"
6978,70,3,Wallis,3961,1300,973,-327,-109,"13,9"
6980,53,2,Basel-Stadt,4055,1280,965,-315,-158,"18,2"
6981,40,2,Schaffhausen,8200,1250,608,-642,-321,"15,2"
6982,80,3,Zürich,8478,1310,1496,186,62,"18,7"
6983,136,"4,5",Schwyz,8807,2130,2128,-2,0,"15,65"
6987,170,"4,5",Aargau,5076,1650,2423,773,172,"14,25"
6988,50,2,Thurgau,9545,990,720,-270,-135,"14,4"
6989,103,"3,5",Tessin,6962,1950,1391,-559,-160,"13,5"
6990,70,"2,5",Zürich,8902,1790,1379,-411,-164,"19,7"
6991,35,1,Zürich,8052,1200,763,-437,-437,"21,8"
6992,89,"3,5",Luzern,6206,2050,1317,-733,-209,"14,8"
6993,102,"4,5",Luzern,6033,1880,1443,-437,-97,"14,15"
6994,67,3,Luzern,6005,1600,1032,-568,-189,"15,4"
6999,80,"2,5",Luzern,6020,1490,1288,-202,-81,"16,1"
7000,70,"2,5",Zürich,8107,1550,1379,-171,-68,"19,7"
7001,119,"5,5",Aargau,4323,2600,1684,-916,-167,"14,15"
7002,75,3,St. Gallen,9008,1195,1080,-115,-38,"14,4"
7003,136,"4,5",Schwyz,8852,3600,2128,-1472,-327,"15,65"
7004,85,"4,5",Thurgau,8580,1140,1050,-90,-20,"12,35"
7004,85,"4,5",St. Gallen,8580,1140,1109,-31,-7,"13,05"
7009,85,"4,5",Aargau,4323,2130,1211,-919,-204,"14,25"
7010,69,4,Bern,3012,1740,973,-767,-192,"14,1"
7011,82,3,Waadt,1110,1922,1402,-520,-173,"17,1"
7013,70,"3,5",Bern,3604,1440,1001,-439,-125,"14,3"
7017,15,1,Bern,3818,600,240,-360,-360,16
7019,79,"3,5",Bern,4934,1350,1130,-220,-63,"14,3"
7023,94,"3,5",St. Gallen,9444,1590,1302,-288,-82,"13,85"
7024,94,"3,5",Zürich,8197,1820,1701,-119,-34,"18,1"
7025,89,"3,5",Wallis,1950,1500,1179,-321,-92,"13,25"
7026,88,4,Zürich,8309,1755,1540,-215,-54,"17,5"
7027,75,"3,5",Luzern,6006,1550,1110,-440,-126,"14,8"
7028,42,"1,5",Zürich,8304,1160,893,-267,-178,"21,25"
7030,143,"4,5",Solothurn,4226,2400,1845,-555,-123,"12,9"
7031,78,"3,5",Basel-Landschaft,4123,1750,1283,-467,-133,"16,45"
7034,50,"2,5",Freiburg,1752,1275,763,-512,-205,"15,25"
7035,75,"3,5",Bern,3110,1330,1073,-257,-73,"14,3"
7036,141,"4,5",Luzern,6260,2350,1995,-355,-79,"14,15"
7037,87,"4,5",Luzern,6003,1930,1231,-699,-155,"14,15"
7038,99,4,Bern,3053,1550,1396,-154,-39,"14,1"
7039,56,"2,5",Luzern,6020,1220,902,-318,-127,"16,1"
7041,23,1,Bern,3053,700,368,-332,-332,16
7042,62,3,Bern,3006,1500,899,-601,-200,"14,5"
7045,76,3,Bern,3006,1680,1102,-578,-193,"14,5"
7046,64,2,Bern,3014,1205,973,-232,-116,"15,2"
7049,51,2,Nidwalden,6374,1400,847,-553,-277,"16,6"
7050,131,"5,5",Aargau,4852,2050,1854,-196,-36,"14,15"
7051,97,"3,5",St. Gallen,9200,2000,1343,-657,-188,"13,85"
7052,97,"4,5",Zürich,8610,2150,1702,-448,-100,"17,55"
7053,116,"4,5",Aargau,5504,1990,1653,-337,-75,"14,25"
7054,62,"2,5",Aargau,4665,1310,964,-346,-138,"15,55"
7055,87,"3,5",Solothurn,2540,1590,1153,-437,-125,"13,25"
7056,114,"4,5",Aargau,4665,1940,1625,-315,-70,"14,25"
7057,89,"3,5",Bern,3014,1985,1273,-712,-203,"14,3"
7058,57,"2,5",Solothurn,2540,1300,784,-516,-206,"13,75"
7059,64,"2,5",Aargau,4665,1340,995,-345,-138,"15,55"
7060,48,"2,5",St. Gallen,8376,950,715,-235,-94,"14,9"
7060,48,"2,5",Thurgau,8376,950,679,-271,-108,"14,15"
7061,69,"3,5",Aargau,4323,1630,1014,-616,-176,"14,7"
7062,107,"4,5",Zürich,8404,2150,1878,-272,-60,"17,55"
7063,91,"3,5",Zürich,8600,2330,1647,-683,-195,"18,1"
7065,90,"3,5",Zürich,8600,2310,1629,-681,-195,"18,1"
7067,83,4,Neuchâtel,2300,1405,1013,-392,-98,"12,2"
7068,169,"5,5",Zürich,8303,3620,3017,-603,-110,"17,85"
7069,34,1,Bern,3400,720,544,-176,-176,16
7071,46,"2,5",Solothurn,4632,1130,633,-497,-199,"13,75"
7075,128,"4,5",Basel-Landschaft,4123,3290,2112,-1178,-262,"16,5"
7076,75,"3,5",Bern,3400,1280,1073,-207,-59,"14,3"
7077,60,3,Zürich,8340,1480,1122,-358,-119,"18,7"
7078,89,"3,5",St. Gallen,9452,1470,1233,-237,-68,"13,85"
7079,45,"2,5",Luzern,6004,1563,725,-838,-335,"16,1"
7080,32,2,Nidwalden,6386,1030,531,-499,-250,"16,6"
7081,107,"4,5",Luzern,6033,1690,1514,-176,-39,"14,15"
7082,91,4,Nidwalden,6374,2000,1374,-626,-157,"15,1"
7083,85,"3,5",Graubünden,7260,1756,1279,-477,-136,"15,05"
7084,73,4,St. Gallen,9100,1150,971,-179,-45,"13,3"
7084,73,4,Appenzell Ausserrhoden,9100,1150,927,-223,-56,"12,7"
7085,90,"3,5",Schwyz,8852,1790,1453,-337,-96,"16,15"
7086,87,"3,5",Zug,6315,2202,1666,-536,-153,"19,15"
7086,87,"3,5",Schwyz,6315,2202,1405,-797,-228,"16,15"
7089,63,"1,5",Aargau,5108,1080,1017,-63,-42,"16,15"
7090,95,"3,5",St. Gallen,9436,1770,1316,-454,-130,"13,85"
7091,62,3,St. Gallen,9220,950,893,-57,-19,"14,4"
7091,62,3,Thurgau,9220,950,862,-88,-29,"13,9"
7093,80,"4,5",Thurgau,9320,1070,988,-82,-18,"12,35"
7094,68,3,Graubünden,7402,1450,1040,-410,-137,"15,3"
7096,60,"2,5",Luzern,6014,1290,966,-324,-130,"16,1"
7098,48,"2,5",Schwyz,6414,1340,818,-522,-209,"17,05"
7100,66,3,St. Gallen,9244,1050,950,-100,-33,"14,4"
7103,103,"3,5",Thurgau,8356,2090,1375,-715,-204,"13,35"
7104,135,"4,5",Thurgau,8580,1880,1667,-213,-47,"12,35"
7104,135,"4,5",St. Gallen,8580,1880,1762,-118,-26,"13,05"
7105,75,3,Zürich,8400,747,1403,656,219,"18,7"
7106,115,"5,5",Luzern,6210,1870,1627,-243,-44,"14,15"
7107,38,2,Glarus,8755,856,578,-278,-139,"15,2"
7108,115,"4,5",Zug,6315,1500,2156,656,146,"18,75"
7108,115,"4,5",Schwyz,6315,1500,1800,300,67,"15,65"
7110,40,2,St. Gallen,9437,800,616,-184,-92,"15,4"
7110,40,2,Appenzell Ausserrhoden,9437,800,600,-200,-100,15
7116,104,"3,5",Zürich,8041,2450,1882,-568,-162,"18,1"
7117,90,"3,5",St. Gallen,9212,1350,1247,-103,-29,"13,85"
7118,30,1,Thurgau,8580,970,414,-556,-556,"13,8"
7118,30,1,St. Gallen,8580,970,477,-493,-493,"15,9"
7119,20,1,Zürich,8132,990,436,-554,-554,"21,8"
7121,130,4,Zürich,8006,3600,2275,-1325,-331,"17,5"
7122,75,3,St. Gallen,9313,1290,1080,-210,-70,"14,4"
7122,75,3,Thurgau,9313,1290,1043,-247,-82,"13,9"
7124,120,"4,5",Graubünden,7302,1446,1620,174,39,"13,5"
7128,92,"2,5",Aargau,4310,1740,1431,-309,-124,"15,55"
7129,110,"4,5",Appenzell Ausserrhoden,9055,1490,1348,-142,-32,"12,25"
7129,110,"4,5",Appenzell Innerrhoden,9055,1490,1408,-82,-18,"12,8"
7132,121,"4,5",Basel-Landschaft,4052,4560,1997,-2563,-570,"16,5"
7132,121,"4,5",Basel-Stadt,4052,4560,2057,-2503,-556,17
7133,105,"3,5",Zürich,8302,2180,1901,-279,-80,"18,1"
7135,67,2,Luzern,6003,1460,1126,-334,-167,"16,8"
7136,122,"3,5",Thurgau,8274,1992,1629,-363,-104,"13,35"
7137,93,"3,5",Thurgau,8274,1690,1242,-448,-128,"13,35"
7138,114,"4,5",St. Gallen,9212,1550,1488,-62,-14,"13,05"
7141,39,"1,5",Graubünden,7000,700,684,-16,-11,"17,55"
7143,61,"2,5",Basel-Stadt,4054,1350,1068,-282,-113,"17,5"
7144,86,"3,5",Bern,3110,1990,1230,-760,-217,"14,3"
7145,92,"4,5",Graubünden,7000,1522,1242,-280,-62,"13,5"
7146,74,"2,5",Bern,3110,1700,1099,-601,-240,"14,85"
7148,94,"3,5",Basel-Landschaft,4104,2250,1546,-704,-201,"16,45"
7149,87,"3,5",Luzern,6014,2060,1288,-772,-221,"14,8"
7150,125,"4,5",Thurgau,8580,1750,1544,-206,-46,"12,35"
7150,125,"4,5",St. Gallen,8580,1750,1631,-119,-26,"13,05"
7152,50,"2,5",Zürich,8953,1687,985,-702,-281,"19,7"
7152,50,"2,5",Aargau,8953,1687,778,-909,-364,"15,55"
7154,93,4,Thurgau,8500,1700,1190,-510,-128,"12,8"
7154,93,4,Zürich,8500,1700,1628,-72,-18,"17,5"
7157,65,"2,5",Freiburg,1700,1300,991,-309,-124,"15,25"
7158,67,"3,5",Freiburg,1700,1350,948,-402,-115,"14,15"
7161,56,"2,5",Aargau,4323,1340,871,-469,-188,"15,55"
7163,58,"2,5",Basel-Landschaft,4142,1480,980,-500,-200,"16,9"
7164,58,"3,5",Neuchâtel,2000,1260,693,-567,-162,"11,95"
7167,76,"3,5",Aargau,5400,1510,1117,-393,-112,"14,7"
7168,117,4,Basel-Landschaft,4052,2600,1895,-705,-176,"16,2"
7168,117,4,Basel-Stadt,4052,2600,1954,-646,-162,"16,7"
7169,77,"4,5",Aargau,8957,1720,1097,-623,-138,"14,25"
7170,62,"3,5",Aargau,8957,1470,911,-559,-160,"14,7"
7171,137,"4,5",Zürich,8180,2575,2404,-171,-38,"17,55"
7172,101,"3,5",Tessin,6616,1875,1364,-511,-146,"13,5"
7173,87,"3,5",Aargau,5630,1850,1279,-571,-163,"14,7"
7175,113,"3,5",Bern,3250,2010,1616,-394,-113,"14,3"
7176,140,"4,5",Tessin,6616,1450,1939,489,109,"13,85"
7177,95,5,Solothurn,5012,1900,1226,-674,-135,"12,9"
7178,113,"4,5",Schwyz,8841,2180,1768,-412,-92,"15,65"
7179,75,"2,5",St. Gallen,8725,1050,1118,68,27,"14,9"
7180,90,"4,5",Zürich,8952,1698,1580,-118,-26,"17,55"
7182,62,3,Zürich,8047,2050,1159,-891,-297,"18,7"
7183,64,3,Tessin,6500,1520,864,-656,-219,"13,5"
7184,83,"3,5",Zürich,8910,1890,1502,-388,-111,"18,1"
7185,100,"5,5",Basel-Landschaft,4133,1910,1760,-150,-27,"17,6"
7187,95,"3,5",Zürich,8302,2470,1720,-750,-214,"18,1"
7188,111,"4,5",Zürich,8302,2845,1948,-897,-199,"17,55"
7189,56,"2,5",Aargau,4310,1380,871,-509,-204,"15,55"
7190,94,"3,5",Zürich,8302,2445,1701,-744,-213,"18,1"
7191,61,"2,5",Zürich,8302,2300,1202,-1098,-439,"19,7"
7192,61,"2,5",Zürich,8302,2005,1202,-803,-321,"19,7"
7193,113,"4,5",Zürich,8302,2870,1983,-887,-197,"17,55"
7197,103,"4,5",Zürich,8006,3800,1808,-1992,-443,"17,55"
7198,56,"1,5",Aargau,5236,990,904,-86,-57,"16,15"
7199,50,"2,5",Zürich,8330,1250,985,-265,-106,"19,7"
7200,39,"1,5",Aargau,5622,820,630,-190,-127,"16,15"
7201,85,"2,5",Luzern,6006,2000,1369,-631,-252,"16,1"
7202,70,3,Solothurn,2540,1087,952,-135,-45,"13,6"
7203,116,"4,5",Zürich,8107,2614,2036,-578,-128,"17,55"
7204,59,"3,5",Aargau,5610,1300,867,-433,-124,"14,7"
7205,110,"4,5",Tessin,6962,1900,1524,-376,-84,"13,85"
7207,107,"4,5",Aargau,6264,1805,1525,-280,-62,"14,25"
7207,107,"4,5",Luzern,6264,1805,1514,-291,-65,"14,15"
7210,50,2,Basel-Landschaft,4123,1590,855,-735,-368,"17,1"
7211,120,4,Zürich,8123,2250,2100,-150,-38,"17,5"
7212,48,3,Zürich,8132,1390,898,-492,-164,"18,7"
7213,118,"4,5",Zürich,8181,2310,2071,-239,-53,"17,55"
7215,70,3,Zürich,8545,1550,1309,-241,-80,"18,7"
7216,60,"3,5",Zürich,8488,1400,1086,-314,-90,"18,1"
7217,50,"2,5",Zürich,8805,1830,985,-845,-338,"19,7"
7219,80,"3,5",Glarus,8874,1500,1016,-484,-138,"12,7"
7220,103,2,Zürich,8032,4450,2132,-2318,-1159,"20,7"
7221,87,"3,5",Luzern,6014,2060,1288,-772,-221,"14,8"
7222,105,"4,5",St. Gallen,9464,1650,1370,-280,-62,"13,05"
7225,132,"4,5",Glarus,8872,3100,1597,-1503,-334,"12,1"
7225,132,"4,5",St. Gallen,8872,3100,1723,-1377,-306,"13,05"
7226,102,"4,5",St. Gallen,8863,1850,1331,-519,-115,"13,05"
7226,102,"4,5",Schwyz,8863,1850,1596,-254,-56,"15,65"
7228,128,"5,5",St. Gallen,8737,1650,1606,-44,-8,"12,55"
7229,95,"4,5",Zürich,8952,2015,1667,-348,-77,"17,55"
7231,77,"3,5",Aargau,5400,1800,1132,-668,-191,"14,7"
7232,93,"3,5",Aargau,5400,1860,1367,-493,-141,"14,7"
7233,79,"3,5",Aargau,5400,1570,1161,-409,-117,"14,7"
7235,107,"4,5",Aargau,5400,1900,1525,-375,-83,"14,25"
7236,32,1,Aargau,5400,850,522,-328,-328,"16,3"
7237,62,3,Aargau,5032,1320,936,-384,-128,"15,1"
7239,75,3,Genf,1202,3500,1388,-2112,-704,"18,5"
7241,69,"3,5",Bern,3097,1440,987,-453,-129,"14,3"
7244,100,"4,5",Waadt,1055,1940,1630,-310,-69,"16,3"
7246,68,"3,5",Zürich,8057,2200,1231,-969,-277,"18,1"
7247,40,2,Graubünden,7500,1340,656,-684,-342,"16,4"
7248,64,3,Tessin,6500,1330,864,-466,-155,"13,5"
7249,105,"4,5",Tessin,6616,1950,1454,-496,-110,"13,85"
7250,76,"3,5",Zürich,8105,1750,1376,-374,-107,"18,1"
7252,76,3,Zürich,8006,2880,1421,-1459,-486,"18,7"
7253,75,3,Zürich,8032,3840,1403,-2437,-812,"18,7"
7254,72,"3,5",Zürich,8003,2438,1303,-1135,-324,"18,1"
7255,84,4,Luzern,6280,1380,1193,-187,-47,"14,2"
7256,87,"2,5",Luzern,6020,1875,1401,-474,-190,"16,1"
7257,105,"3,5",Zürich,8194,1723,1901,178,51,"18,1"
7259,81,4,Zürich,8157,1420,1418,-2,-1,"17,5"
7260,120,"4,5",Tessin,6883,2000,1662,-338,-75,"13,85"
7261,116,"4,5",Zürich,8607,2675,2036,-639,-142,"17,55"
7262,95,"2,5",Zürich,8820,2760,1872,-888,-355,"19,7"
7263,102,"4,5",Zürich,8472,1632,1790,158,35,"17,55"
7266,55,2,Zürich,8003,2000,1139,-861,-431,"20,7"
7267,101,"4,5",Zürich,8248,2130,1773,-357,-79,"17,55"
7268,12,"1,5",Basel-Stadt,4057,850,214,-636,-424,"17,85"
7271,68,3,Solothurn,4657,1125,925,-200,-67,"13,6"
7273,76,"3,5",Tessin,6500,1430,1026,-404,-115,"13,5"
7274,58,2,St. Gallen,9473,966,893,-73,-37,"15,4"
7276,11,"1,5",Basel-Stadt,4057,938,196,-742,-495,"17,85"
7277,97,"3,5",Tessin,6967,2100,1310,-790,-226,"13,5"
7278,23,1,Zürich,8494,850,501,-349,-349,"21,8"
7282,88,4,Zürich,8405,1690,1540,-150,-38,"17,5"
7283,120,"4,5",Aargau,5727,1770,1710,-60,-13,"14,25"
7284,70,"3,5",Schwyz,8750,1490,1131,-359,-103,"16,15"
7284,70,"3,5",Glarus,8750,1490,889,-601,-172,"12,7"
7285,60,3,Aargau,4313,1295,906,-389,-130,"15,1"
7288,300,"3,5",Wallis,1907,1550,3975,2425,693,"13,25"
7289,115,3,Waadt,1097,2800,1967,-833,-278,"17,1"
7290,86,"3,5",Zürich,8103,2080,1557,-523,-149,"18,1"
7291,25,"2,5",Zürich,8497,1550,493,-1057,-423,"19,7"
7292,72,3,Zürich,8048,2095,1346,-749,-250,"18,7"
7293,100,"4,5",Luzern,6232,1750,1415,-335,-74,"14,15"
7294,50,"2,5",Waadt,1006,1340,885,-455,-182,"17,7"
7295,60,"2,5",St. Gallen,8863,1750,894,-856,-342,"14,9"
7295,60,"2,5",Schwyz,8863,1750,1023,-727,-291,"17,05"
7296,80,3,Zürich,8303,1735,1496,-239,-80,"18,7"
7298,137,5,Zürich,8702,5400,2411,-2989,-598,"17,6"
7302,110,4,Basel-Landschaft,4202,2070,1782,-288,-72,"16,2"
7303,95,"4,5",Aargau,4663,1290,1354,64,14,"14,25"
7303,95,"4,5",Solothurn,4663,1290,1226,-64,-14,"12,9"
7305,77,"2,5",Obwalden,6010,2490,1101,-1389,-556,"14,3"
7305,77,"2,5",Nidwalden,6010,2490,1282,-1208,-483,"16,65"
7305,77,"2,5",Luzern,6010,2490,1240,-1250,-500,"16,1"
7308,155,"5,5",Aargau,5035,1830,2193,363,66,"14,15"
7309,130,"5,5",St. Gallen,9534,1650,1632,-18,-3,"12,55"
7311,28,"1,5",Aargau,5452,700,452,-248,-165,"16,15"
7313,141,"4,5",Basel-Stadt,4001,4055,2397,-1658,-368,17
7314,73,"3,5",Basel-Stadt,4057,1540,1223,-317,-91,"16,75"
7316,45,"1,5",Aargau,4800,920,727,-193,-129,"16,15"
7317,48,"2,5",Zürich,8704,1100,946,-154,-62,"19,7"
7320,49,2,Bern,3018,1150,745,-405,-203,"15,2"
7321,26,1,Zürich,8704,850,567,-283,-283,"21,8"
7322,77,"2,5",Schaffhausen,8233,1550,1105,-445,-178,"14,35"
7323,138,"3,5",Schaffhausen,8233,2500,1815,-685,-196,"13,15"
7324,99,"4,5",Aargau,4813,850,1411,561,125,"14,25"
7325,129,"5,5",Aargau,4813,1280,1825,545,99,"14,15"
7326,13,1,Thurgau,9542,390,179,-211,-211,"13,8"
7327,122,"4,5",Luzern,6207,1988,1726,-262,-58,"14,15"
7328,92,"2,5",Thurgau,8360,1710,1302,-408,-163,"14,15"
7329,72,"2,5",Luzern,6253,1370,1159,-211,-84,"16,1"
7331,66,1,Bern,3011,1280,1056,-224,-224,16
7333,70,"3,5",Waadt,1462,1460,1155,-305,-87,"16,5"
7334,78,3,Wallis,1868,1250,1084,-166,-55,"13,9"
7335,127,"5,5",Schwyz,8846,2220,2064,-156,-28,"16,25"
7337,127,"5,5",Schwyz,8846,2380,2064,-316,-57,"16,25"
7338,112,"4,5",St. Gallen,8722,1970,1462,-508,-113,"13,05"
7339,101,"3,5",Zürich,8633,2100,1828,-272,-78,"18,1"
7339,101,"3,5",St. Gallen,8633,2100,1399,-701,-200,"13,85"
7340,85,"4,5",Aargau,5605,1395,1211,-184,-41,"14,25"
7341,19,1,Zürich,8052,1160,414,-746,-746,"21,8"
7342,70,"3,5",Zürich,8700,2900,1267,-1633,-467,"18,1"
7354,112,"4,5",Thurgau,8580,1750,1383,-367,-82,"12,35"
7354,112,"4,5",St. Gallen,8580,1750,1462,-288,-64,"13,05"
7359,102,"3,5",St. Gallen,8863,2230,1413,-817,-233,"13,85"
7359,102,"3,5",Schwyz,8863,2230,1647,-583,-167,"16,15"
7360,155,"5,5",Zürich,8703,5400,2767,-2633,-479,"17,85"
7361,124,"4,5",St. Gallen,9247,1855,1618,-237,-53,"13,05"
7362,97,"3,5",Thurgau,9553,1625,1295,-330,-94,"13,35"
7364,66,"3,5",Bern,3110,1255,944,-311,-89,"14,3"
7366,120,4,Bern,2503,1600,1692,92,23,"14,1"
7368,105,"4,5",Bern,3004,2290,1454,-836,-186,"13,85"
7369,95,"3,5",Appenzell Innerrhoden,9450,1300,1330,30,9,14
7369,95,"3,5",Appenzell Ausserrhoden,9450,1300,1211,-89,-25,"12,75"
7369,95,"3,5",St. Gallen,9450,1300,1316,16,5,"13,85"
7371,55,2,Bern,3273,780,836,56,28,"15,2"
7374,60,"3,5",Bern,3634,1120,858,-262,-75,"14,3"
7375,87,"4,5",St. Gallen,9658,1150,1135,-15,-3,"13,05"
7376,55,"3,5",Bern,3473,1400,787,-613,-175,"14,3"
7379,80,4,Bern,3752,1350,1128,-222,-56,"14,1"
7380,35,1,Bern,3004,830,560,-270,-270,16
7382,70,"3,5",Bern,3072,1690,1001,-689,-197,"14,3"
7383,60,"2,5",Bern,3315,1150,891,-259,-104,"14,85"
7384,116,"4,5",Bern,4922,1840,1607,-233,-52,"13,85"
7385,53,"2,5",Bern,3132,1019,787,-232,-93,"14,85"
7387,80,"3,5",Bern,3700,1490,1144,-346,-99,"14,3"
7388,90,4,Bern,3770,1400,1269,-131,-33,"14,1"
7390,120,4,Bern,2503,1600,1692,92,23,"14,1"
7391,100,"4,5",St. Gallen,9205,1600,1305,-295,-66,"13,05"
7397,70,"3,5",Bern,3273,1110,1001,-109,-31,"14,3"
7398,45,"2,5",Bern,3714,750,668,-82,-33,"14,85"
7400,75,"3,5",Thurgau,8590,1351,1001,-350,-100,"13,35"
7403,79,3,Freiburg,1726,1630,1169,-461,-154,"14,8"
7404,85,"3,5",St. Gallen,9000,1290,1177,-113,-32,"13,85"
7405,49,2,Zürich,8340,1509,1014,-495,-248,"20,7"
7408,55,2,Bern,3004,1960,836,-1124,-562,"15,2"
7409,126,"4,5",Zürich,8053,3175,2211,-964,-214,"17,55"
7410,130,"5,5",Waadt,1822,2150,2210,60,11,17
7439,48,2,Luzern,6174,350,806,456,228,"16,8"
7440,90,"4,5",Zürich,8317,1695,1580,-115,-26,"17,55"
7441,92,"3,5",Luzern,6005,2735,1362,-1373,-392,"14,8"
7443,100,4,Zürich,8118,1990,1750,-240,-60,"17,5"
7444,75,3,Zürich,8704,1960,1403,-557,-186,"18,7"
7445,48,"1,5",Zürich,8003,1840,1020,-820,-547,"21,25"
7446,91,"3,5",Waadt,1400,1810,1502,-308,-88,"16,5"
7447,65,"2,5",Waadt,1188,1580,1151,-429,-172,"17,7"
7448,76,3,Zürich,8712,1580,1421,-159,-53,"18,7"
7449,120,"5,5",St. Gallen,8636,1880,1506,-374,-68,"12,55"
7449,120,"5,5",Zürich,8636,1880,2142,262,48,"17,85"
7450,103,"5,5",Appenzell Ausserrhoden,9425,1670,1164,-506,-92,"11,3"
7450,103,"5,5",St. Gallen,9425,1670,1293,-377,-69,"12,55"
7451,107,"2,5",Schaffhausen,8200,1410,1535,125,50,"14,35"
7452,58,"2,5",Zürich,8600,1650,1143,-507,-203,"19,7"
7453,90,3,St. Gallen,9630,960,1296,336,112,"14,4"
7463,92,"3,5",Basel-Landschaft,4123,2150,1513,-637,-182,"16,45"
7464,100,"3,5",Luzern,6020,1570,1480,-90,-26,"14,8"
7465,90,"2,5",Aargau,5243,1400,1400,0,0,"15,55"
7466,57,"2,5",Aargau,5417,1380,886,-494,-198,"15,55"
7468,75,"3,5",St. Gallen,9014,1280,1039,-241,-69,"13,85"
7468,75,"3,5",Appenzell Ausserrhoden,9014,1280,956,-324,-93,"12,75"
7469,90,4,St. Gallen,9000,1350,1197,-153,-38,"13,3"
7470,63,4,St. Gallen,9030,1180,838,-342,-86,"13,3"
7471,53,3,St. Gallen,9030,1050,763,-287,-96,"14,4"
7473,69,3,Basel-Landschaft,4133,1550,1152,-398,-133,"16,7"
7474,121,1,Zürich,8057,1790,2638,848,848,"21,8"
7475,60,3,Solothurn,4612,1270,816,-454,-151,"13,6"
7476,70,"2,5",Luzern,6206,1365,1127,-238,-95,"16,1"
7478,70,4,Zürich,8820,1498,1225,-273,-68,"17,5"
7480,107,"4,5",Bern,3172,2120,1482,-638,-142,"13,85"
7481,75,"3,5",St. Gallen,9400,1130,1039,-91,-26,"13,85"
7484,80,"3,5",Aargau,5103,1550,1176,-374,-107,"14,7"
7485,160,"5,5",Waadt,1170,3400,2720,-680,-124,17
7501,72,"2,5",Luzern,6253,1370,1159,-211,-84,"16,1"
7503,75,"3,5",Schaffhausen,8200,1240,986,-254,-73,"13,15"
7508,52,2,Wallis,1971,840,775,-65,-33,"14,9"
7509,110,"3,5",Wallis,1913,1600,1458,-142,-41,"13,25"
7510,60,"2,5",Wallis,1965,1450,864,-586,-234,"14,4"
7512,70,3,Waadt,1374,1600,1197,-403,-134,"17,1"
7513,92,"3,5",Waadt,1337,1100,1518,418,119,"16,5"
7514,145,"5,5",Genf,1206,4500,2980,-1520,-276,"20,55"
7516,50,"2,5",Wallis,1926,1350,720,-630,-252,"14,4"
7517,117,"4,5",Waadt,1085,2350,1907,-443,-98,"16,3"
7517,117,"4,5",Freiburg,1085,2350,1580,-770,-171,"13,5"
7518,58,3,Genf,1226,2200,1073,-1127,-376,"18,5"
7519,117,"4,5",Basel-Landschaft,4123,2494,1931,-563,-125,"16,5"
7520,98,"3,5",Basel-Landschaft,4123,2111,1612,-499,-143,"16,45"
7522,156,5,Basel-Stadt,4055,2550,2699,149,30,"17,3"
7523,105,"4,5",Schwyz,6422,1570,1643,73,16,"15,65"
7524,90,"3,5",Aargau,5420,1680,1323,-357,-102,"14,7"
7526,70,"2,5",Aargau,5737,1450,1089,-361,-144,"15,55"
7527,80,3,Bern,3752,1270,1160,-110,-37,"14,5"
7528,95,5,St. Gallen,8735,1700,1216,-484,-97,"12,8"
7530,144,"5,5",Basel-Landschaft,4148,2370,2534,164,30,"17,6"
7531,99,"2,5",Aargau,5737,1650,1539,-111,-44,"15,55"
7537,170,"3,5",Thurgau,8265,2900,2270,-630,-180,"13,35"
7538,98,"3,5",Bern,4900,1650,1401,-249,-71,"14,3"
7540,117,"3,5",Aargau,5737,1680,1720,40,11,"14,7"
7541,90,"3,5",Neuchâtel,2416,1090,1076,-14,-4,"11,95"
7542,122,"5,5",Luzern,6103,2350,1726,-624,-113,"14,15"
7546,70,"3,5",Basel-Landschaft,4053,3300,1152,-2148,-614,"16,45"
7546,70,"3,5",Basel-Stadt,4053,3300,1173,-2127,-608,"16,75"
7550,160,"5,5",Zürich,8820,4350,2856,-1494,-272,"17,85"
7553,110,"5,5",Zürich,8187,2170,1964,-206,-37,"17,85"
7556,85,"4,5",St. Gallen,8722,1700,1109,-591,-131,"13,05"
7558,100,4,Waadt,1802,2150,1590,-560,-140,"15,9"
7560,184,"4,5",Luzern,6045,4900,2604,-2296,-510,"14,15"
7561,115,"4,5",Luzern,6103,2230,1627,-603,-134,"14,15"
7562,128,"4,5",Bern,3856,1790,1773,-17,-4,"13,85"
7563,182,"5,5",St. Gallen,9642,2640,2284,-356,-65,"12,55"
7564,105,4,Waadt,1350,1500,1670,170,43,"15,9"
7565,65,"2,5",Aargau,5027,1330,1011,-319,-128,"15,55"
7566,80,"3,5",Aargau,5027,1540,1176,-364,-104,"14,7"
7568,90,"3,5",Waadt,1610,2200,1485,-715,-204,"16,5"
7570,70,"3,5",Freiburg,1563,1290,991,-299,-85,"14,15"
7571,122,"5,5",Luzern,6103,2350,1726,-624,-113,"14,15"
7573,80,"3,5",Wallis,1926,1640,1060,-580,-166,"13,25"
7575,80,"3,5",Wallis,3974,1500,1060,-440,-126,"13,25"
7576,120,"4,5",Thurgau,8590,1980,1482,-498,-111,"12,35"
7578,90,"4,5",Zürich,8494,1650,1580,-70,-16,"17,55"
7580,117,"3,5",Aargau,5737,1680,1720,40,11,"14,7"
7581,197,"4,5",Waadt,1372,2750,3211,461,102,"16,3"
7582,100,"3,5",Waadt,1009,2150,1650,-500,-143,"16,5"
7584,120,"4,5",Waadt,1188,2370,1956,-414,-92,"16,3"
7586,150,5,Waadt,1530,1900,2505,605,121,"16,7"
7589,40,1,St. Gallen,9000,735,636,-99,-99,"15,9"
7590,100,"3,5",St. Gallen,9200,1800,1385,-415,-119,"13,85"
7591,95,4,St. Gallen,9000,1345,1264,-81,-20,"13,3"
7592,38,1,Obwalden,6063,700,604,-96,-96,"15,9"
7593,102,"4,5",Solothurn,4413,1750,1316,-434,-96,"12,9"
7594,120,"3,5",St. Gallen,9430,1750,1662,-88,-25,"13,85"
7595,66,"3,5",Graubünden,7203,1540,993,-547,-156,"15,05"
7598,100,"3,5",Luzern,6020,1570,1480,-90,-26,"14,8"
7599,60,3,Basel-Landschaft,4123,1770,1002,-768,-256,"16,7"
7600,100,"4,5",Thurgau,8560,1490,1235,-255,-57,"12,35"
7601,75,3,Bern,3414,1360,1088,-272,-91,"14,5"
7602,53,"2,5",Thurgau,8587,900,750,-150,-60,"14,15"
7603,50,"2,5",Zürich,8355,1011,985,-26,-10,"19,7"
7603,50,"2,5",Thurgau,8355,1011,708,-303,-121,"14,15"
7604,105,"4,5",St. Gallen,9602,1430,1370,-60,-13,"13,05"
7605,95,4,Thurgau,8500,1220,1216,-4,-1,"12,8"
7605,95,4,Zürich,8500,1220,1663,443,111,"17,5"
7606,112,"4,5",St. Gallen,9000,2360,1462,-898,-200,"13,05"
7609,117,"4,5",Obwalden,6010,2690,1544,-1146,-255,"13,2"
7609,117,"4,5",Nidwalden,6010,2690,1755,-935,-208,15
7609,117,"4,5",Luzern,6010,2690,1656,-1034,-230,"14,15"
7610,80,"3,5",Thurgau,8587,1120,1068,-52,-15,"13,35"
7611,34,2,Aargau,4310,770,544,-226,-113,16
7613,55,"3,5",St. Gallen,9630,990,762,-228,-65,"13,85"
7615,71,"2,5",St. Gallen,9650,1710,1058,-652,-261,"14,9"
7616,76,"3,5",St. Gallen,9650,1820,1053,-767,-219,"13,85"
7617,52,"2,5",St. Gallen,9650,1490,775,-715,-286,"14,9"
7618,59,"2,5",St. Gallen,9650,1600,879,-721,-288,"14,9"
7619,74,"3,5",St. Gallen,9650,1820,1025,-795,-227,"13,85"
7620,62,"2,5",St. Gallen,9650,1590,924,-666,-266,"14,9"
7621,81,"3,5",St. Gallen,9650,2080,1122,-958,-274,"13,85"
7622,66,3,Basel-Landschaft,4052,1550,1102,-448,-149,"16,7"
7622,66,3,Basel-Stadt,4052,1550,1109,-441,-147,"16,8"
7624,60,"2,5",St. Gallen,9434,1000,894,-106,-42,"14,9"
7626,80,4,St. Gallen,9400,1250,1064,-186,-47,"13,3"
7627,139,"3,5",Schwyz,6405,4590,2245,-2345,-670,"16,15"
7628,123,"4,5",Schwyz,6405,3470,1925,-1545,-343,"15,65"
7629,107,"3,5",Schwyz,6405,2790,1728,-1062,-303,"16,15"
7630,120,"4,5",Zürich,8932,2450,2106,-344,-76,"17,55"
7631,77,"1,5",Thurgau,9536,950,1086,136,91,"14,1"
7631,77,"1,5",St. Gallen,9536,950,1205,255,170,"15,65"
7633,95,"4,5",Thurgau,8552,1220,1173,-47,-10,"12,35"
7634,78,"3,5",Nidwalden,6370,1750,1240,-510,-146,"15,9"
7636,95,"4,5",Thurgau,8512,1472,1173,-299,-66,"12,35"
7637,123,"4,5",St. Gallen,9326,2400,1605,-795,-177,"13,05"
7637,123,"4,5",Thurgau,9326,2400,1519,-881,-196,"12,35"
7638,75,4,Basel-Landschaft,4104,1840,1215,-625,-156,"16,2"
7639,107,"4,5",Luzern,6030,2250,1514,-736,-164,"14,15"
7642,70,"3,5",Thurgau,9320,1640,935,-705,-201,"13,35"
7643,75,"3,5",St. Gallen,8636,1142,1039,-103,-29,"13,85"
7643,75,"3,5",Zürich,8636,1142,1358,216,62,"18,1"
7645,35,"1,5",St. Gallen,7320,1350,548,-802,-535,"15,65"
7646,49,"2,5",Thurgau,9500,1190,693,-497,-199,"14,15"
7646,49,"2,5",St. Gallen,9500,1190,730,-460,-184,"14,9"
7648,82,"3,5",Waadt,1260,2580,1353,-1227,-351,"16,5"
7649,85,"4,5",Uri,6460,1460,1080,-380,-84,"12,7"
7650,25,1,Graubünden,7260,1230,468,-762,-762,"18,7"
7653,25,1,Schwyz,6430,600,447,-153,-153,"17,9"
7654,90,"4,5",St. Gallen,9100,1650,1175,-475,-106,"13,05"
7654,90,"4,5",Appenzell Ausserrhoden,9100,1650,1103,-547,-122,"12,25"
7658,160,"4,5",Bern,3098,4000,2216,-1784,-396,"13,85"
7660,50,2,Basel-Stadt,4057,1090,910,-180,-90,"18,2"
7661,65,"2,5",Basel-Landschaft,4252,1150,1099,-51,-20,"16,9"
7661,65,"2,5",Solothurn,4252,1150,894,-256,-102,"13,75"
7663,30,1,Graubünden,7000,700,561,-139,-139,"18,7"
7664,45,2,Luzern,6020,1250,756,-494,-247,"16,8"
7666,69,"2,5",Bern,3008,1960,1025,-935,-374,"14,85"
7667,14,1,                                                                                                                                                                                                                                                                                                                                                                                                                                                                                                                                                                                                                                                                                                                                                                                                                                                                                                                                                                                                                                                                                                                                                                                                                                                                                                                                                                                                                                                                                                                                                                                                                                                                                                                                                                                                                                                                                                                                                                                                                                                                                                                                                                                                                                                                                                                                                                                                                                                                                                                                                                                                                                                                                                                                                                                                                                                                                                                                                                                                                                                                                                                                                                                                                                                                                                                                                                                                                                                                                                                                                                                                                                                                                                                                                                                                                                                                                                                                                                                                                                                                                                                                                                                                                                                                                                                                                                                                                                                                                                                                                                                                                                                                                                                                                                                                                                                                                                                                                                                                                                                                                                                                                                                                                                                                                                                                                                                                                                                                                                                                                                                                                                                                                                                                                                                                                                                                                                                                                                                                                                                                                                                                                                                                                                                                                                                                                                                                                                                                                                                                                                                                                                                                                                                                                                                                                                                                                                                                                                                                                                                                                                                                                                                                                                                                                                                                                                                                                                                                                                                                                                                                                                                                                                                                                                                                                                                                                                                                                                                                                                                                                                                                                                                                                                                                                                                                                                                                                                                                                                                                                                                                                                                                                                                                                                                                                                                                                                                                                                                                                                                                                                                                                                                                                                                                                                                                                                                                                                                                                                                                                                                                                                                                                                                                                                                                                                                                                                                                                                                                                                                                                                                                                                                                                                                                                                                                                                                                                                                                                                                                                                                                                                                                                                                                                                                                                                                                                                                                                                                                                                                                                                                                                                                                                                                                                                                                                                                                                                                                                                                                                                                                                                                                                                                                                                                                                                                                                                                                                                                                                                                                                                                                                                                                                                                                                                                                                                                                                                                                                                                                                                                                                                                                                                                                                                                                                                                                                                                                                                                                                                                                                                                                                                                                                                                                                                                                                                                                                                                                                                                                                                                                                                                                                                                                                                                                                                                                                                                                                                                                                                                                                                                                                                                                                                                                                                                                                                                                                                                                                                                                                                                                                                                                                                                                                                                                                                                                                                                                                                                                                                                                                                                                                                                                                                                                                                                                                                                                                                                                                                                                                                                                                                                                                                                                                                                                                                                                                                                                                                                                                                                                                                                                                                                                                                                                                                                                                                                                                                                                                                                                                                                                                                                                                                                                                                                                                                                                                                                                                                                                                                                                                                                                                                                                                                                                                                                                                                                                                                                                                                                                                                                                                                                                                                                                                                                                                                                                                                                                                                                                                                                                                                                                                                                                                                                                                                                                                                                                                                                                                                                                                                                                                                                                                                                                                                                                                                                                                                                                                                                                                                                                                                                                                                                                                                                                                                                                                                                                                                                                                                                                                                                                                                                                                                                                                                                                                                                                                                                                                                                                                                                                                                                                                                                                                                                                                                                                                                                                                                                                                                                                                                                                                                                                                                                                                                                                                                                                                                                                                                                                                                                                                                                                                                                                                                                                                                                                                                                                                                                                                                                                                                                                                                                                                                                                                                                                                                                                                                                                                                                                                                                                                                                                                                                                                                                                                                                                                                                                                                                                                                                                                                                                                                                                                                                                                                                                                                                                                                                                                                                                                                                                                                                                                                                                                                                                                                                                                                                                                                                                                                                                                                                                                                                                                                                                                                                                                                                                                                                                                                                                                                                                                                                                                                                                                                                                                                                                                                                                                                                                                                                                                                                                                                                                                                                                                                                                                                                                                                                                                                                                                                                                                                                                                                                                                                                                                                                                                                                                                                                                                                                                                                                                                                                                                                                                                                                                                                                                                                                                                                                                                                                                                                                                                                                                                                                                                                                                                                                                                                                                                                                                                                                                                                                                                                                                                                                                                                                                                                                                                                                                                                                                                                                                                                                                                                                                                                                                                                                                                                                                                                                                                                                                                                                                                                                                                                                                                                                                                                                                                                                                                                                                                                                                                                                                                                                                                                                                                                                                                                                                                                                                                                                                                                                                                                                                                                                                                                                                                                                                                                                                                                                                                                                                                                                                                                                                                                                                                                                                                                                                                                                                                                                                                                                                                                                                                                                                                                                                                                                                                                                                                                                                                                                                                                                                                                                                                                                                                                                                                                                                                                                                                                                                                                                                                                                                                                                                                                                                                                                                                                                                                                                                                                                                                                                                                                                                                                                                                                                                                                                                                                                                                                                                                                                                                                                                                                                                                                                                                                                                                                                                                                                                                                                                                                                                                                                                                                                                                                                                                                                                                                                                                                                                                                                                                                                                                                                                                                                                                                                                                                                                                                                                                                                                                                                                                                                                                                                                                                                                                                                                                                                                                                                                                                                                                                                                                                                                                                                                                                                                                                                                                                                                                                                                                                                                                                                                                                                                                                                                                                                                                                                                                                                                                                                                                                                                                                                                                                                                                                                                                                                                                                                                                                                                                                                                                                                                                                                                                                                                                                                                                                                                                                                                                                                                                                                                                                                                                                                                                                                                                                                                                                                                                                                                                                                                                                                                                                                                                                                                                                                                                                                                                                                                                                                                                                                                                                                                                                                                                                                                                                                                                                                                                                                                                                                                                                                                                                                                                                                                                                                                                                                                                                                                                                                                                                                                                                                                                                                                                                                                                                                                                                                                                                                                                                                                                                                                                                                                                                                                                                                                                                                                                                                                                                                                                                                                                                                                                                                                                                                                                                                                                                                                                                                                                                                                                                                                                                                                                                                                                                                                                                                                                                                                                                                                                                                                                                                                                                                                                                                                                                                                                                                                                                                                                                                                                                                                                                                                                                                                                                                                                                                                                                                                                                                                                                                                                                                                                                                                                                                                                                                                                                                                                                                                                                                                                                                                                                                                                                                                                                                                                                                                                                                                                                                                                                                                                                                                                                                                                                                                                                                                                                                                                                                                                                                                                                                                                                                                                                                                                                                                                                                                                                                                                                                                                                                                                                                                                                                                                                                                                                                                                                                                                                                                                                                                                                                                                                                                                                                                                                                                                                                                                                                                                                                                                                                                                                                                                                                                                                                                                                                                                                                                                                                                                                                                                                                                                                                                                                                                                                                                                                                                                                                                                                                                                                                                                                                                                                                                                                                                                                                                                                                                                                                                                                                                                                                                                                                                                                                                                                                                                                                                                                                                                                                                                                                                                                                                                                                                                                                                                                                                                                                                                                                                                                                                                                                                                                                                                                                                                                                                                                                                                                                                                                                                                                                                                                                                                                                                                                                                                                                                                                                                                                                                                                                                                                                                                                                                                                                                                                                                                                                                                                                                                                                                                                                                                                                                                                                                                                                                                                                                                                                                                                                                                                                                                                                                                                                                                                                                                                                                                                                                                                                                                                                                                                                                                                                                                                                                                                                                                                                                                                                                                                                                                                                                                                                                                                                                                                                                                                                                                                                                                                                                                                                                                                                                                                                                                                                                                                                                                                                                                                                                                                                                                                                                                                                                                                                                                                                                                                                                                                                                                                                                                                                                                                                                                                                                                                                                                                                                                                                                                                                                                                                                                                                                                                                                                                                                                                                                                                                                                                                                                                                                                                                                                                                                                                                                                                                                                                                                                                                                                                                                                                                                                                                                                                                                                                                                                                                                                                                                                                                                                                                                                                                                                                                                                                                                                                                                                                                                                                                                                                                                                                                                                                                                                                                                                                                                                                                                                                                                                                                                                                                                                                                                                                                                                                                                                                                                                                                                                                                                                                                                                                                                                                                                                                                                                                                                                                                                                                                                                                                                                                                                                                                                                                                                                                                                                                                                                                                                                                                                                                                                                                                                                                                                                                                                                                                                                                                                                                                                                                                                                                                                                                                                                                                                                                                                                                                                                                                                                                                                                                                                                                                                                                                                                                                                                                                                                                                                                                                                                                                                                                                                                                                                                                                                                                                                                                                                                                                                                                                                                                                                                                                                                                                                                                                                                                                                                                                                                                                                                                                                                                                                                                                                                                                                                                                                                                                                                                                                                                                                                                                                                                                                                                                                                                                                                                                                                                                                                                                                                                                                                                                                                                                                                                                                                                                                                                                                                                                                                                                                                                                                                                                                                                                                                                                                                                                                                                                                                                                                                                                                                                                                                                                                                                                                                                                                                                                                                                                                                                                                                                                                                                                                                                                                                                                                                                                                                                                                                                                                                                                                                                                                                                                                                                                                                                                                                                                                                                                                                                                                                                                                                                                                                                                                                                                                                                                                                                                                                                                                                                                                                                                                                                                                                                                                                                                                                                                                                                                                                                                                                                                                                                                                                                                                                                                                                                                                                                                                                                                                                                                                                                                                                                                                                                                                                                                                                                                                                                                                                                                                                                                                                                                                                                                                                                                                                                                                                                                                                                                                                                                                                                                                                                                                                                                                                                                                                                                                                                                                                                                                                                                                                                                                                                                                                                                                                                                                                                                                                                                                                                                                                                                                                                                                                                                                                                                                                                                                                                                                                                                                                                                                                                                                                                                                                                                                                                                                                                                                                                                                                                                                                                                                                                                                                                                                                                                                                                                                                                                                                                                                                                                                                                                                                                                                                                                                                                                                                                                                                                                                                                                                                                                                                                                                                                                                                                                                                                                                                                                                                                                                                                                                                                                                                                                                                                                                                                                                                                                                                                                                                                                                                                                                                                                                                                                                                                                                                                                                                                                                                                                                                                                                                                                                                                                                                                                                                                                                                                                                                                                                                                                                                                                                                                                                                                                                                                                                                                                                                                                                                                                                                                                                                                                                                                                                                                                                                                                                                                                                                                                                                                                                                                                                                                                                                                                                                                                                                                                                                                                                                                                                                                                                                                                                                                                                                                                                                                                                                                                                                                                                                                                                                                                                                                                                                                                                                                                                                                                                                                                                                                                                                                                                                                                                                                                                                                                                                                                                                                                                                                                                                                                                                                                                                                                                                                                                                                                                                                                                                                                                                                                                                                                                                                                                                                                                                                                                                                                                                                                                                                                                                                                                                                                                                                                                                                                                                                                                                                                                                                                                                                                                                                                                                                                                                                                                                                                                                                                                                                                                                                                                                                                                                                                                                                                                                                                                                                                                                                                                                                                                                                                                                                                                                                                                                                                                                                                                                                                                                                                                                                                                                                                                                                                                                                                                                                                                                                                                                                                                                                                                                                                                                                                                                                                                                                                                                                                                                                                                                                                                                                                                                                                                                                                                                                                                                                                                                                                                                                                                                                                                                                                                                                                                                                                                                                                                                                                                                                                                                                                                                                                                                                                                                                                                                                                                                                                                                                                                                                                                                                                                                                                                                                                                                                                                                                                                                                                                                                                                                                                                                                                                                                                                                                                                                                                                                                                                                                                                                                                                                                                                                                                                                                                                                                                                                                                                                                                                                                                                                                                                                                                                                                                                                                                                                                                                                                                                                                                                                                                                                                                                                                                                                                                                                                                                                                                                                                                                                                                                                                                                                                                                                                                                                                                                                                                                                                                                                                                                                                                                                                                                                                                                                                                                                                                                                                                                                                                                                                                                                                                                                                                                                                                                                                                                                                                                                                                                                                                                                                                                                                                                                                                                                                                                                                                                                                                                                                                                                                                                                                                                                                                                                                                                                                                                                                                                                                                                                                                                                                                                                                                                                                                                                                                                                                                                                                                                                                                                                                                                                                                                                                                                                                                                                                                                                                                                                                                                                                                                                                                                                                                                                                                                                                                                                                                                                                                                                                                                                                                                                                                                                                                                                                                                                                                                                                                                                                                                                                                                                                                                                                                                                                                                                                                                                                                                                                                                                                                                                                                                                                                                                                                                                                                                                                                                                                                                                                                                                                                                                                                                                                                                                                                                                                                                                                                                                                                                                                                                                                                                                                                                                                                                                                                                                                                                                                                                                                                                                                                                                                                                                                                                                                                                                                                                                                                                                                                                                                                                                                                                                                                                                                                                                                                                                                                                                                                                                                                                                                                                                                                                                                                                                                                                                                                                                                                                                                                                                                                                                                                                                                                                                                                                                                                                                                                                                                                                                                                                                                                                                                                                                                                                                                                                                                                                                                                                                                                                                                                                                                                                                                                                                                                                                                                                                                                                                                                                                                                                                                                                                                                                                                                                                                                                                                                                                                                                                                                                                                                                                                                                                                                                                                                                                                                                                                                                                                                                                                                                                                                                                                                                                                                                                                                                                                                                                                                                                                                                                                                                                                                                                                                                                                                                                                                                                                                                                                                                                                                                                                                                                                                                                                                                                                                                                                                                                                                                                                                                                                                                                                                                                                                                                                                                                                                                                                                                                                                                                                                                                                                                                                                                                                                                                                                                                                                                                                                                                                                                                                                                                                                                                                                                                                                                                                                                                                                                                                                                                                                                                                                                                                                                                                                                                                                                                                                                                                                                                                                                                                                                                                                                                                                                                                                                                                                                                                                                                                                                                                                                                                                                                                                                                                                                                                                                                                                                                                                                                                                                                                                                                                                                                                                                                                                                                                                                                                                                                                                                                                                                                                                                                                                                                                                                                                                                                                                                                                                                                                                                                                                                                                                                                                                                                                                                                                                                                                                                                                                                                                                                                                                                                                                                                                                                                                                                                                                                                                                                                                                                                                                                                                                                                                                                                                                                                                                                                                                                                                                                                                                                                                                                                                                                                                                                                                                                                                                                                                                                                                                                                                                                                                                                                                                                                                                                                                                                                                                                                                                                                                                                                                                                                                                                                                                                                                                                                                                                                                                                                                                                                                                                                                                                                                                                                                                                                                                                                                                                                                                                                                                                                                                                                                                                                                                                                                                                                                                                                                                                                                                                                                                                                                                                                                                                                                                                                                                                                                                                                                                                                                                                                                                                                                                                                                                                                                                                                                                                                                                                                                                                                                                                                                                                                                                                                                                                                                                                                                                                                                                                                                                                                                                                                                                                                                                                                                                                                                                                                                                                                                                                                                                                                                                                                                                                                                                                                                                                                                                                                                                                                                                                                                                                                                                                                                                                                                                                                                                                                                                                                                                                                                                                                                                                                                                                                                                                                                                                                                                                                                                                                                                                                                                                                                                                                                                                                                                                                                                                                                                                                                                                                                                                                                                                                                                                                                                                                                                                                                                                                                                                                                                                                                                                                                                                                                                                                                                                                                                                                                                                                                                                                                                                                                                                                                                                                                                                                                                                                                                                                                                                                                                                                                                                                                                                                                                                                                                                                                                                                                                                                                                                                                                                                                                                                                                                                                                                                                                                                                                                                                                                                                                                                                                                                                                                                                                                                                                                                                                                                                                                                                                                                                                                                                                                                                                                                                                                                                                                                                                                                                                                                                                                                                                                                                                                                                                                                                                                                                                                                                                                                                                                                                                                                                                                                                                                                                                                                                                                                                                                                                                                                                                                                                                                                                                                                                                                                                                                                                                                                                                                                                                                                                                                                                                                                                                                                                                                                                                                                                                                                                                                                                                                                                                                                                                                                                                                                                                                                                                                                                                                                                                                                                                                                                                                                                                                                                                                                                                                                                                                                                                                                                                                                                                                                                                                                                                                                                                                                                                                                                                                                                                                                                                                                                                                                                                                                                                                                                                                                                                                                                                                                                                                                                                                                                                                                                                                                                                                                                                                                                                                                                                                                                                                                                                                                                                                                                                                                                                                                                                                                                                                                                                                                                                                                                                                                                                                                                                                                                                                                                                                                                                                                                                                                                                                                                                                                                                                                                                                                                                                                                                                                                                                                                                                                                                                                                                                                                                                                                                                                                                                                                                                                                                                                                                                                                                                                                                                                                                                                                                                                                                                                                                                                                                                                                                                                                                                                                                                                                                                                                                                                                                                                                                                                                                                                                                                                                                                                                                                                                                                                                                                                                                                                                                                                                                                                                                                                                                                                                                                                                                                                                                                                                                                                                                                                                                                                                                                                                                                                                                                                                                                                                                                                                                                                                                                                                                                                                                                                                                                                                                                                                                                                                                                                                                                                                                                                                                                                                                                                                                                                                                                                                                                                                                                                                                                                                                                                                                                                                                                                                                                                                                                                                                                                                                                                                                                                                                                                                                                                                                                                                                                                                                                                                                                                                                                                                                                                                                                                                                                                                                                                                                                                                                                                                                                                                                                                                                                                                                                                                                                                                                                                                                                                                                                                                                                                                                                                                                                                                                                                                                                                                                                                                                                                                                                                                                                                                                                                                                                                                                                                                                                                                                                                                                                                                                                                                                                                                                                                                                                                                                                                                                                                                                                                                                                                                                                                                                                                                                                                                                                                                                                                                                                                                                                                                                                                                                                                                                                                                                                                                                                                                                                                                                                                                                                                                                                                                                                                                                                                                                                                                                                                                                                                                                                                                                                                                                                                                                                                                                                                                                                                                                                                                                                                                                                                                                                                                                                                                                                                                                                                                                                                                                                                                                                                                                                                                                                                                                                                                                                                                                                                                                                                                                                                                                                                                                                                                                                                                                                                                                                                                                                                                                                                                                                                                                                                                                                                                                                                                                                                                                                                                                                                                                                                                                                                                                                                                                                                                                                                                                                                                                                                                                                                                                                                                                                                                                                                                                                                                                                                                                                                                                                                                                                                                                                                                                                                                                                                                                                                                                                                                                                                                                                                                                                                                                                                                                                                                                                                                                                                                                                                                                                                                                                                                                                                                                                                                                                                                                                                                                                                                                                                                                                                                                                                                                                                                                                                                                                                                                                                                                                                                                                                                                                                                                                                                                                                                                                                                                                                                                                                                                                                                                                                                                                                                                                                                                                                                                                                                                                                                                                                                                                                                                                                                                                                                                                                                                                                                                                                                                                                                                                                                                                                                                                                                                                                                                                                                                                                                                                                                                                                                                                                                                                                                                                                                                                                                                                                                                                                                                                                                                                                                                                                                                                                                                                                                                                                                                                                                                                                                                                                                                                                                                                                                                                                                                                                                                                                                                                                                                                                                                                                                                                                                                                                                                                                                                                                                                                                                                                                                                                                                                                                                                                                                                                                                                                                                                                                                                                                                                                                                                                                                                                                                                                                                                                                                                                                                                                                                                                                                                                                                                                                                                                                                                                                                                                                                                                                                                                                                                                                                                                                                                                                                                                                                                                                                                                                                                                                                                                                                                                                                                                                                                                                                                                                                                                                                                                                                                                                                                                                                                                                                                                                                                                                                                                                                                                                                                                                                                                                                                                                                                                                                                                                                                                                                                                                                                                                                                                                                                                                                                                                                                                                                                                                                                                                                                                                                                                                                                                                                                                                                                                                                                                                                                                                                                                                                                                                                                                                                                                                                                                                                                                                                                                                                                                                                                                                                                                                                                                                                                                                                                                                                                                                                                                                                                                                                                                                                                                                                                                                                                                                                                                                                                                                                                                                                                                                                                                                                                                                                                                                                                                                                                                                                                                                                                                                                                                                                                                                                                                                                                                                                                                                                                                                                                                                                                                                                                                                                                                                                                                                                                                                                                                                                                                                                                                                                                                                                                                                                                                                                                                                                                                                                                                                                                                                                                                                                                                                                                                                                                                                                                                                                                                                                                                                                                                                                                                                                                                                                                                                                                                                                                                                                                                                                                                                                                                                                                                                                                                                                                                                                                                                                                                                                                                                                                                                                                                                                                                                                                                                                                                                                                                                                                                                                                                                                                                                                                                                                                                                                                                                                                                                                                                                                                                                                                                                                                                                                                                                                                                                                                                                                                                                                                                                                                                                                                                                                                                                                                                                                                                                                                                                                                                                                                                                                                                                                                                                                                                                                                                                                                                                                                                                                                                                                                                                                                                                                                                                                                                                                                                                                                                                                                                                                                                                                                                                                                                                                                                                                                                                                                                                                                                                                                                                                                                                                                                                                                                                                                                                                                                                                                                                                                                                                                                                                                                                                                                                                                                                                                                                                                                                                                                                                                                                                                                                                                                                                                                                                                                                                                                                                                                                                                                                                                                                                                                                                                                                                                                                                                                                                                                                                                                                                                                                                                                                                                                                                                                                                                                                                                                                                                                                                                                                                                                                                                                                                                                                                                                                                                                                                                                                                                                                                                                                                                                                                                                                                                                                                                                                                                                                                                                                                                                                                                                                                                                                                                                                                                                                                                                                                                                                                                                                                                                                                                                                                                                                                                                                                                                                                                                                                                                                                                                                                                                                                                                                                                                                                                                                                                                                                                                                                                                                                                                                                                                                                                                                                                                                                                                                                                                                                                                                                                                                                                                                                                                                                                                                                                                                                                                                                                                                                                                                                                                                                                                                                                                                                                                                                                                                                                                                                                                                                                                                                                                                                                                                                                                                                                                                                                                                                                                                                                                                                                                                                                                                                                                                                                                                                                                                                                                                                                                                                                                                                                                                                                                                                                                                                                                                                                                                                                                                                                                                                                                                                                                                                                                                                                                                                                                                                                                                                                                                                                                                                                                                                                                                                                                                                                                                                                                                                                                                                                                                                                                                                                                                                                                                                                                                                                                                                                                                                                                                                                                                                                                                                                                                                                                                                                                                                                                                                                                                                                                                                                                                                                                                                                                                                                                                                                                                                                                                                                                                                                                                                                                                                                                                                                                                                                                                                                                                                                                                                                                                                                                                                                                                                                                                                                                                                                                                                                                                                                                                                                                                                                                                                                                                                                                                                                                                                                                                                                                                                                                                                                                                                                                                                                                                                                                                                                                                                                                                                                                                                                                                                                                                                                                                                                                                                                                                                                                                                                                                                                                                                                                                                                                                                                                                                                                                                                                                                                                                                                                                                                                                                                                                                                                                                                                                                                                                                                                                                                                                                                                                                                                                                                                                                                                                                                                                                                                                                                                                                                                                                                                                                                                                                                                                                                                                                                                                                                                                                                                                                                                                                                                                                                                                                                                                                                                                                                                                                                                                                                                                                                                                                                                                                                                                                                                                                                                                                                                                                                                                                                                                                                                                                                                                                                                                                                                                                                                                                                                                                                                                                                                                                                                                                                                                                                                                                                                                                                                                                                                                                                                                                                                                                                                                                                                                                                                                                                                                                                                                                                                                                                                                                                                                                                                                                                                                                                                                                                                                                                                                                                                                                                                                                                                                                                                                                                                                                                                                                                                                                                                                                                                                                                                                                                                                                                                                                                                                                                                                                                                                                                                                                                                                                                                                                                                                                                                                                                                                                                                                                                                                                                                                                                                                                                                                                                                                                                                                                                                                                                                                                                                                                                                                                                                                                                                                                                                                                                                                                                                                                                                                                                                                                                                                                                                                                                                                                                                                                                                                                                                                                                                                                                                                                                                                                                                                                                                                                                                                                                                                                                                                                                                                                                                                                                                                                                                                                                                                                                                                                                                                                                                                                                                                                                                                                                                                                                                                                                                                                                                                                                                                                                                                                                                                                                                                                                                                                                                                                                                                                                                                                                                                                                                                                                                                                                                                                                                                                                                                                                                                                                                                                                                                                                                                                                                                                                                                                                                                                                                                                                                                                                                                                                                                                                                                                                                                                                                                                                                                                                                                                                                                                                                                                                                                                                                                                                                                                                                                                                                                                                                                                                                                                                                                                                                                                                                                                                                                                                                                                                                                                                                                                                                                                                                                                                                                                                                                                                                                                                                                                                                                                                                                                                                                                                                                                                                                                                                                                                                                                                                                                                                                                                                                                                                                                                                                                                                                                                                                                                                                                                                                                                                                                                                                                                                                                                                                                                                                                                                                                                                                                                                                                                                                                                                                                                                                                                                                                                                                                                                                                                                                                                                                                                                                                                                                                                                                                                                                                                                                                                                                                                                                                                                                                                                                                                                                                                                                                                                                                                                                                                                                                                                                                                                                                                                                                                                                                                                                                                                                                                                                                                                                                                                                                                                                                                                                                                                                                                                                                                                                                                                                                                                                                                                                                                                                                                                                                                                                                                                                                                                                                                                                                                                                                                                                                                                                                                                                                                                                                                                                                                                                                                                                                                                                                                                                                                                                                                                                                                                                                                                                                                                                                                                                                                                                                                                                                                                                                                                                                                                                                                                                                                                                                                                                                                                                                                                                                                                                                                                                                                                                                                                                                                                                                                                                                                                                                                                                                                                                                                                                                                                                                                                                                                                                                                                                                                                                                                                                                                                                                                                                                                                                                                                                                                                                                                                                                                                                                                                                                                                                                                                                                                                                                                                                                                                                                                                                                                                                                                                                                                                                                                                                                                                                                                                                                                                                                                                                                                                                                                                                                                                                                                                                                                                                                                                                                                                                                                                                                                                                                                                                                                                                                                                                                                                                                                                                                                                                                                                                                                                                                                                                                                                                                                                                                                                                                                                                                                                                                                                                                                                                                                                                                                                                                                                                                                                                                                                                                                                                                                                                                                                                                                                                                                                                                                                                                                                                                                                                                                                                                                                                                                                                                                                                                                                                                                                                                                                                                                                                                                                                                                                                                                                                                                                                                                                                                                                                                                                                                                                                                                                                                                                                                                                                                                                                                                                                                                                                                                                                                                                                                                                                                                                                                                                                                                                                                                                                                                                                                                                                                                                                                                                                                                                                                                                                                                                                                                                                                                                                                                                                                                                                                                                                                                                                                                                                                                                                                                                                                                                                                                                                                                                                                                                                                                                                                                                                                                                                                                                                                                                                                                                                                                                                                                                                                                                                                                                                                                                                                                                                                                                                                                                                                                                                                                                                                                                                                                                                                                                                                                                                                                                                                                                                                                                                                                                                                                                                                                                                                                                                                                                                                                                                                                                                                                                                                                                                                                                                                                                                                                                                                                                                                                                                                                                                                                                                                                                                                                                                                                                                                                                                                                                                                                                                                                                                                                                                                                                                                                                                                                                                                                                                                                                                                                                                                                                                                                                                                                                                                                                                                                                                                                                                                                                                                                                                                                                                                                                                                                                                                                                                                                                                                                                                                                                                                                                                                                                                                                                                                                                                                                                                                                                                                                                                                                                                                                                                                                                                                                                                                                                                                                                                                                                                                                                                                                                                                                                                                                                                                                                                                                                                                                                                                                                                                                                                                                                                                                                                                                                                                                                                                                                                                                                                                                                                                                                                                                                                                                                                                                                                                                                                                                                                                                                                                                                                                                                                                                                                                                                                                                                                                                                                                                                                                                                                                                                                                                                                                                                                                                                                                                                                                                                                                                                                                                                                                                                                                                                                                                                                                                                                                                                                                                                                                                                                                                                                                                                                                                                                                                                                                                                                                                                                                                                                                                                                                                                                                                                                                                                                                                                                                                                                                                                                                                                                                                                                                                                                                                                                                                                                                                                                                                                                                                                                                                                                                                                                                                                                                                                                                                                                                                                                                                                                                                                                                                                                                                                                                                                                                                                                                                                                                                                                                                                                                                                                                                                                                                                                                                                                                                                                                                                                                                                                                                                                                                                                                                                                                                                                                                                                                                                                                                                                                                                                                                                                                                                                                                                                                                                                                                                                                                                                                                                                                                                                                                                                                                                                                                                                                                                                                                                                                                                                                                                                                                                                                                                                                                                                                                                                                                                                                                                                                                                                                                                                                                                                                                                                                                                                                                                                                                                                                                                                                                                                                                                                                                                                                                                                                                                                                                                                                                                                                                                                                                                                                                                                                                                                                                                                                                                                                                                                                                                                                                                                                                                                                                                                                                                                                                                                                                                                                                                                                                                                                                                                                                                                                                                                                                                                                                                                                                                                                                                                                                                                                                                                                                                                                                                                                                                                                                                                                                                                                                                                                                                                                                                                                                                                                                                                                                                                                                                                                                                                                                                                                                                                                                                                                                                                                                                                                                                                                                                                                                                                                                                                                                                                                                                                                                                                                                                                                                                                                                                                                                                                                                                                                                                                                                                                                                                                                                                                                                                                                                                                                                                                                                                                                                                                                                                                                                                                                                                                                                                                                                                                                                                                                                                                                                                                                                                                                                                                                                                                                                                                                                                                                                                                                                                                                                                                                                                                                                                                                                                                                                                                                                                                                                                                                                                                                                                                                                                                                                                                                                                                                                                                                                                                                                                                                                                                                                                                                                                                                                                                                                                                                                                                                                                                                                                                                                                                                                                                                                                                                                                                                                                                                                                                                                                                                                                                                                                                                                                                                                                                                                                                                                                                                                                                                                                                                                                                                                                                                                                                                                                                                                                                                                                                                                                                                                                                                                                                                                                                                                                                                                                                                                                                                                                                                                                                                                                                                                                                                                                                                                                                                                                                                                                                                                                                                                                                                                                                                                                                                                                                                                                                                                                                                                                                                                                                                                                                                                                                                                                                                                                                                                                                                                                                                                                                                                                                                                                                                                                                                                                                                                                                                                                                                                                                                                                                                                                                                                                                                                                                                                                                                                                                                                                                                                                                                                                                                                                                                                                                                                                                                                                                                                                                                                                                                                                                                                                                                                                                                                                                                                                                                                                                                                                                                                                                                                                                                                                                                                                                                                                                                                                                                                                                                                                                                                                                                                                                                                                                                                                                                                                                                                                                                                                                                                                                                                                                                                                                                                                                                                                                                                                                                                                                                                                                                                                                                                                                                                                                                                                                                                                                                                                                                                                                                                                                                                                                                                                                                                                                                                                                                                                                                                                                                                                                                                                                                                                                                                                                                                                                                                                                                                                                                                                                                                                                                                                                                                                                                                                                                                                                                                                                                                                                                                                                                                                                                                                                                                                                                                                                                                                                                                                                                                                                                                                                                                                                                                                                                                                                                                                                                                                                                                                                                                                                                                                                                                                                                                                                                                                                                                                                                                                                                                                                                                                                                                                                                                                                                                                                                                                                                                                                                                                                                                                                                                                                                                                                                                                                                                                                                                                                                                                                                                                                                                                                                                                                                                                                                                                                                                                                                                                                                                                                                                                                                                                                                                                                                                                                                                                                                                                                                                                                                                                                                                                                                                                                                                                                                                                                                                                                                                                                                                                                                                                                                                                                                                                                                                                                                                                                                                                                                                                                                                                                                                                                                                                                                                                                                                                                                                                                                                                                                                                                                                                                                                                                                                                                                                                                                                                                                                                                                                                                                                                                                                                                                                                                                                                                                                                                                                                                                                                                                                                                                                                                                                                                                                                                                                                                                                                                                                                                                                                                                                                                                                                                                                                                                                                                                                                                                                                                                                                                                                                                                                                                                                                                                                                                                                                                                                                                                                                                                                                                                                                                                                                                                                                                                                                                                                                                                                                                                                                                                                                                                                                                                                                                                                                                                                                                                                                                                                                                                                                                                                                                                                                                                                                                                                                                                                                                                                                                                                                                                                                                                                                                                                                                                                                                                                                                                                                                                                                                                                                                                                                                                                                                                                                                                                                                                                                                                                                                                                                                                                                                                                                                                                                                                                                                                                                                                                                                                                                                                                                                                                                                                                                                                                                                                                                                                                                                                                                                                                                                                                                                                                                                                                                                                                                                                                                                                                                                                                                                                                                                                                                                                                                                                                                                                                                                                                                                                                                                                                                                                                                                                                                                                                                                                                                                                                                                                                                                                                                                                                                                                                                                                                                                                                                                                                                                                                                                                                                                                                                                                                                                                                                                                                                                                                                                                                                                                                                                                                                                                                                                                                                                                                                                                                                                                                                                                                                                                                                                                                                                                                                                                                                                                                                                                                                                                                                                                                                                                                                                                                                                                                                                                                                                                                                                                                                                                                                                                                                                                                                                                                                                                                                                                                                                                                                                                                                                                                                                                                                                                                                                                                                                                                                                                                                                                                                                                                                                                                                                                                                                                                                                                                                                                                                                                                                                                                                                                                                                                                                                                                                                                                                                                                                                                                                                                                                                                                                                                                                                                                                                                                                                                                                                                                                                                                                                                                                                                                                                                                                                                                                                                                                                                                                                                                                                                                                                                                                                                                                                                                                                                                                                                                                                                                                                                                                                                                                                                                                                                                                                                                                                                                                                                                                                                                                                                                                                                                                                                                                                                                                                                                                                                                                                                                                                                                                                                                                                                                                                                                                                                                                                                                                                                                                                                                                                                                                                                                                                                                                                                                                                                                                                                                                                                                                                                                                                                                                                                                                                                                                                                                                                                                                                                                                                                                                                                                                                                                                                                                                                                                                                                                                                                                                                                                                                                                                                                                                                                                                                                                                                                                                                                                                                                                                                                                                                                                                                                                                                                                                                                                                                                                                                                                                                                                                                                                                                                                                                                                                                                                                                                                                                                                                                                                                                                                                                                                                                                                                                                                                                                                                                                                                                                                                                                                                                                                                                                                                                                                                                                                                                                                                                                                                                                                                                                                                                                                                                                                                                                                                                                                                                                                                                                                                                                                                                                                                                                                                                                                                                                                                                                                                                                                                                                                                                                                                                                                                                                                                                                                                                                                                                                                                                                                                                                                                                                                                                                                                                                                                                                                                                                                                                                                                                                                                                                                                                                                                                                                                                                                                                                                                                                                                                                                                                                                                                                                                                                                                                                                                                                                                                                                                                                                                                                                                                                                                                                                                                                                                                                                                                                                                                                                                                                                                                                                                                                                                                                                                                                                                                                                                                                                                                                                                                                                                                                                                                                                                                                                                                                                                                                                                                                                                                                                                                                                                                                                                                                                                                                                                                                                                                                                                                                                                                                                                                                                                                                                                                                                                                                                                                                                                                                                                                                                                                                                                                                                                                                                                                                                                                                                                                                                                                                                                                                                                                                                                                                                                                                                                                                                                                                                                                                                                                                                                                                                                                                                                                                                                                                                                                                                                                                                                                                                                                                                                                                                                                                                                                                                                                                                                                                                                                                                                                                                                                                                                                                                                                                                                                                                                                                                                                                                                                                                                                                                                                                                                                                                                                                                                                                                                                                                                                                                                                                                                                                                                                                                                                                                                                                                                                                                                                                                                                                                                                                                                                                                                                                                                                                                                                                                                                                                                                                                                                                                                                                                                                                                                                                                                                                                                                                                                                                                                                                                                                                                                                                                                                                                                                                                                                                                                                                                                                                                                                                                                                                                                                                                                                                                                                                                                                                                                                                                                                                                                                                                                                                                                                                                                                                                                                                                                                                                                                                                                                                                                                                                                                                                                                                                                                                                                                                                                                                                                                                                                                                                                                                                                                                                                                                                                                                                                                                                                                                                                                                                                                                                                                                                                                                                                                                                                                                                                                                                                                                                                                                                                                                                                                                                                                                                                                                                                                                                                                                                                                                                                                                                                                                                                                                                                                                                                                                                                                                                                                                                                                                                                                                                                                                                                                                                                                                                                                                                                                                                                                                                                                                                                                                                                                                                                                                                                                                                                                                                                                                                                                                                                                                                                                                                                                                                                                                                                                                                                                                                                                                                                                                                                                                                                                                                                                                                                                                                                                                                                                                                                                                                                                                                                                                                                                                                                                                                                                                                                                                                                                                                                                                                                                                                                                                                                                                                                                                                                                                                                                                                                                                                                                                                                                                                                                                                                                                                                                                                                                                                                                                                                                                                                                                                                                                                                                                                                                                                                                                                                                                                                                                                                                                                                                                                                                                                                                                                                                                                                                                                                                                                                                                                                                                                                                                                                                                                                                                                                                                                                                                                                                                                                                                                                                                                                                                                                                                                                                                                                                                                                                                                                                                                                                                                                                                                                                                                                                                                                                                                                                                                                                                                                                                                                                                                                                                                                                                                                                                                                                                                                                                                                                                                                                                                                                                                                                                                                                                                                                                                                                                                                                                                                                                                                                                                                                                                                                                                                                                                                                                                                                                                                                                                                                                                                                                                                                                                                                                                                                                                                                                                                                                                                                                                                                                                                                                                                                                                                                                                                                                                                                                                                                                                                                                                                                                                                                                                                                                                                                                                                                                                                                                                                                                                                                                                                                                                                                                                                                                                                                                                                                                                                                                                                                                                                                                                                                                                                                                                                                                                                                                                                                                                                                                                                                                                                                                                                                                                                                                                                                                                                                                                                                                                                                                                                                                                                                                                                                                                                                                                                                                                                                                                                                                                                                                                                                                                                                                                                                                                                                                                                                                                                                                                                                                                                                                                                                                                                                                                                                                                                                                                                                                                                                                                                                                                                                                                                                                                                                                                                                                                                                                                                                                                                                                                                                                                                                                                                                                                                                                                                                                                                                                                                                                                                                                                                                                                                                                                                                                                                                                                                                                                                                                                                                                                                                                                                                                                                                                                                                                                                                                                                                                                                                                                                                                                                                                                                                                                                                                                                                                                                                                                                                                                                                                                                                                                                                                                                                                                                                                                                                                                                                                                                                                                                                                                                                                                                                                                                                                                                                                                                                                                                                                                                                                                                                                                                                                                                                                                                                                                                                                                                                                                                                                                                                                                                                                                                                                                                                                                                                                                                                                                                                                                                                                                                                                                                                                                                                                                                                                                                                                                                                                                                                                                                                                                                                                                                                                                                                                                                                                                                                                                                                                                                                                                                                                                                                                                                                                                                                                                                                                                                                                                                                                                                                                                                                                                                                                                                                                                                                                                                                                                                                                                                                                                                                                                                                                                                                                                                                                                                                                                                                                                                                                                                                                                                                                                                                                                                                                                                                                                                                                                                                                                                                                                                                                                                                                                                                                                                                                                                                                                                                                                                                                                                                                                                                                                                                                                                                                                                                                                                                                                                                                                                                                                                                                                                                                                                                                                                                                                                                                                                                                                                                                                                                                                                                                                                                                                                                                                                                                                                                                                                                                                                                                                                                                                                                                                                                                                                                                                                                                                                                                                                                                                                                                                                                                                                                                                                                                                                                                                                                                                                                                                                                                                                                                                                                                                                                                                                                                                                                                                                                                                                                                                                                                                                                                                                                                                                                                                                                                                                                                                                                                                                                                                                                                                                                                                                                                                                                                                                                                                                                                                                                                                                                                                                                                                                                                                                                                                                                                                                                                                                                                                                                                                                                                                                                                                                                                                                                                                                                                                                                                                                                                                                                                                                                                                                                                                                                                                                                                                                                                                                                                                                                                                                                                                                                                                                                                                                                                                                                                                                                                                                                                                                                                                                                                                                                                                                                                                                                                                                                                                                                                                                                                                                                                                                                                                                                                                                                                                                                                                                                                                                                                                                                                                                                                                                                                                                                                                                                                                                                                                                                                                                                                                                                                                                                                                                                                                                                                                                                                                                                                                                                                                                                                                                                                                                                                                                                                                                                                                                                                                                                                                                                                                                                                                                                                                                                                                                                                                                                                                                                                                                                                                                                                                                                                                                                                                                                                                                                                                                                                                                                                                                                                                                                                                                                                                                                                                                                                                                                                                                                                                                                                                                                                                                                                                                                                                                                                                                                                                                                                                                                                                                                                                                                                                                                                                                                                                                                                                                                                                                                                                                                                                                                                                                                                                                                                                                                                                                                                                                                                                                                                                                                                                                                                                                                                                                                                                                                                                                                                                                                                                                                                                                                                                                                                                                                                                                                                                                                                                                                                                                                                                                                                                                                                                                                                                                                                                                                                                                                                                                                                                                                                                                                                                                                                                                                                                                                                                                                                                                                                                                                                                                                                                                                                                                                                                                                                                                                                                                                                                                                                                                                                                                                                                                                                                                                                                                                                                                                                                                                                                                                                                                                                                                                                                                                                                                                                                                                                                                                                                                                                                                                                                                                                                                                                                                                                                                                                                                                                                                                                                                                                                                                                                                                                                                                                                                                                                                                                                                                                                                                                                                                                                                                                                                                                                                                                                                                                                                                                                                                                                                                                                                                                                                                                                                                                                                                                                                                                                                                                                                                                                                                                                                                                                                                                                                                                                                                                                                                                                                                                                                                                                                                                                                                                                                                                                                                                                                                                                                                                                                                                                                                                                                                                                                                                                                                                                                                                                                                                                                                                                                                                                                                                                                                                                                                                                                                                                                                                                                                                                                                                                                                                                                                                                                                                                                                                                                                                                                                                                                                                                                                                                                                                                                                                                                                                                                                                                                                                                                                                                                                                                                                                                                                                                                                                                                                                                                                                                                                                                                                                                                                                                                                                                                                                                                                                                                                                                                                                                                                                                                                                                                                                                                                                                                                                                                                                                                                                                                                                                                                                                                                                                                                                                                                                                                                                                                                                                                                                                                                                                                                                                                                                                                                                                                                                                                                                                                                                                                                                                                                                                                                                                                                                                                                                                                                                                                                                                                                                                                                                                                                                                                                                                                                                                                                                                                                                                                                                                                                                                                                                                                                                                                                                                                                                                                                                                                                                                                                                                                                                                                                                                                                                                                                                                                                                                                                                                                                                                                                                                                                                                                                                                                                                                                                                                                                                                                                                                                                                                                                                                                                                                                                                                                                                                                                                                                                                                                                                                                                                                                                                                                                                                                                                                                                                                                                                                                                                                                                                                                                                                                                                                                                                                                                                                                                                                                                                                                                                                                                                                                                                                                                                                                                                                                                                                                                                                                                                                                                                                                                                                                                                                                                                                                                                                                                                                                                                                                                                                                                                                                                                                                                                                                                                                                                                                                                                                                                                                                                                                                                                                                                                                                                                                                                                                                                                                                                                                                                                                                                                                                                                                                                                                                                                                                                                                                                                                                                                                                                                                                                                                                                                                                                                                                                                                                                                                                                                                                                                                                                                                                                                                                                                                                                                                                                                                                                                                                                                                                                                                                                                                                                                                                                                                                                                                                                                                                                                                                                                                                                                                                                                                                                                                                                                                                                                                                                                                                                                                                                                                                                                                                                                                                                                                                                                                                                                                                                                                                                                                                                                                                                                                                                                                                                                                                                                                                                                                                                                                                                                                                                                                                                                                                                                                                                                                                                                                                                                                                                                                                                                                                                                                                                                                                                                                                                                                                                                                                                                                                                                                                                                                                                                                                                                                                                                                                                                                                                                                                                                                                                                                                                                                                                                                                                                                                                                                                                                                                                                                                                                                                                                                                                                                                                                                                                                                                                                                                                                                                                                                                                                                                                                                                                                                                                                                                                                                                                                                                                                                                                                                                                                                                                                                                                                                                                                                                                                                                                                                                                                                                                                                                                                                                                                                                                                                                                                                                                                                                                                                                                                                                                                                                                                                                                                                                                                                                                                                                                                                                                                                                                                                                                                                                                                                                                                                                                                                                                                                                                                                                                                                                                                                                                                                                                                                                                                                                                                                                                                                                                                                                                                                                                                                                                                                                                                                                                                                                                                                                                                                                                                                                                                                                                                                                                                                                                                                                                                                                                                                                                                                                                                                                                                                                                                                                                                                                                                                                                                                                                                                                                                                                                                                                                                                                                                                                                                                                                                                                                                                                                                                                                                                                                                                                                                                                                                                                                                                                                                                                                                                                                                                                                                                                                                                                                                                                                                                                                                                                                                                                                                                                                                                                                                                                                                                                                                                                                                                                                                                                                                                                                                                                                                                                                                                                                                                                                                                                                                                                                                                                                                                                                                                                                                                                                                                                                                                                                                                                                                                                                                                                                                                                                                                                                                                                                                                                                                                                                                                                                                                                                                                                                                                                                                                                                                                                                                                                                                                                                                                                                                                                                                                                                                                                                                                                                                                                                                                                                                                                                                                                                                                                                                                                                                                                                                                                                                                                                                                                                                                                                                                                                                                                                                                                                                                                                                                                                                                                                                                                                                                                                                                                                                                                                                                                                                                                                                                                                                                                                                                                                                                                                                                                                                                                                                                                                                                                                                                                                                                                                                                                                                                                                                                                                                                                                                                                                                                                                                                                                                                                                                                                                                                                                                                                                                                                                                                                                                                                                                                                                                                                                                                                                                                                                                                                                                                                                                                                                                                                                                                                                                                                                                                                                                                                                                                                                                                                                                                                                                                                                                                                                                                                                                                                                                                                                                                                                                                                                                                                                                                                                                                                                                                                                                                                                                                                                                                                                                                                                                                                                                                                                                                                                                                                                                                                                                                                                                                                                                                                                                                                                                                                                                                                                                                                                                                                                                                                                                                                                                                                                                                                                                                                                                                                                                                                                                                                                                                                                                                                                                                                                                                                                                                                                                                                                                                                                                                                                                                                                                                                                                                                                                                                                                                                                                                                                                                                                                                                                                                                                                                                                                                                                                                                                                                                                                                                                                                                                                                                                                                                                                                                                                                                                                                                                                                                                                                                                                                                                                                                                                                                                                                                                                                                                                                                                                                                                                                                                                                                                                                                                                                                                                                                                                                                                                                                                                                                                                                                                                                                                                                                                                                                                                                                                                                                                                                                                                                                                                                                                                                                                                                                                                                                                                                                                                                                                                                                                                                                                                                                                                                                                                                                                                                                                                                                                                                                                                                                                                                                                                                                                                                                                                                                                                                                                                                                                                                                                                                                                                                                                                                                                                                                                                                                                                                                                                                                                                                                                                                                                                                                                                                                                                                                                                                                                                                                                                                                                                                                                                                                                                                                                                                                                                                                                                                                                                                                                                                                                                                                                                                                                                                                                                                                                                                                                                                                                                                                                                                                                                                                                                                                                                                                                                                                                                                                                                                                                                                                                                                                                                                                                                                                                                                                                                                                                                                                                                                                                                                                                                                                                                                                                                                                                                                                                                                                                                                                                                                                                                                                                                                                                                                                                                                                                                                                                                                                                                                                                                                                                                                                                                                                                                                                                                                                                                                                                                                                                                                                                                                                                                                                                                                                                                                                                                                                                                                                                                                                                                                                                                                                                                                                                                                                                                                                                                                                                                                                                                                                                                                                                                                                                                                                                                                                                                                                                                                                                                                                                                                                                                                                                                                                                                                                                                                                                                                                                                                                                                                                                                                                                                                                                                                                                                                                                                                                                                                                                                                                                                                                                                                                                                                                                                                                                                                                                                                                                                                                                                                                                                                                                                                                                                                                                                                                                                                                                                                                                                                                                                                                                                                                                                                                                                                                                                                                                                                                                                                                                                                                                                                                                                                                                                                                                                                                                                                                                                                                                                                                                                                                                                                                                                                                                                                                                                                                                                                                                                                                                                                                                                                                                                                                                                                                                                                                                                                                                                                                                                                                                                                                                                                                                                                                                                                                                                                                                                                                                                                                                                                                                                                                                                                                                                                                                                                                                                                                                                                                                                                                                                                                                                                                                                                                                                                                                                                                                                                                                                                                                                                                                                                                                                                                                                                                                                                                                                                                                                                                                                                                                                                                                                                                                                                                                                                                                                                                                                                                                                                                                                                                                                                                                                                                                                                                                                                                                                                                                                                                                                                                                                                                                                                                                                                                                                                                                                                                                                                                                                                                                                                                                                                                                                                                                                                                                                                                                                                                                                                                                                                                                                                                                                                                                                                                                                                                                                                                                                                                                                                                                                                                                                                                                                                                                                                                                                                                                                                                                                                                                                                                                                                                                                                                                                                                                                                                                                                                                                                                                                                                                                                                                                                                                                                                                                                                                                                                                                                                                                                                                                                                                                                                                                                                                                                                                                                                                                                                                                                                                                                                                                                                                                                                                                                                                                                                                                                                                                                                                                                                                                                                                                                                                                                                                                                                                                                                                                                                                                                                                                                                                                                                                                                                                                                                                                                                                                                                                                                                                                                                                                                                                                                                                                                                                                                                                                                                                                                                                                                                                                                                                                                                                                                                                                                                                                                                                                                                                                                                                                                                                                                                                                                                                                                                                                                                                                                                                                                                                                                                                                                                                                                                                                                                                                                                                                                                                                                                                                                                                                                                                                                                                                                                                                                                                                                                                                                                                                                                                                                                                                                                                                                                                                                                                                                                                                                                                                                                                                                                                                                                                                                                                                                                                                                                                                                                                                                                                                                                                                                                                                                                                                                                                                                                                                                                                                                                                                                                                                                                                                                                                                                                                                                                                                                                                                                                                                                                                                                                                                                                                                                                                                                                                                                                                                                                                                                                                                                                                                                                                                                                                                                                                                                                                                                                                                                                                                                                                                                                                                                                                                                                                                                                                                                                                                                                                                                                                                                                                                                                                                                                                                                                                                                                                                                                                                                                                                                                                                                                                                                                                                                                                                                                                                                                                                                                                                                                                                                                                                                                                                                                                                                                                                                                                                                                                                                                                                                                                                                                                                                                                                                                                                                                                                                                                                                                                                                                                                                                                                                                                                                                                                                                                                                                                                                                                                                                                                                                                                                                                                                                                                                                                                                                                                                                                                                                                                                                                                                                                                                                                                                                                                                                                                                                                                                                                                                                                                                                                                                                                                                                                                                                                                                                                                                                                                                                                                                                                                                                                                                                                                                                                                                                                                                                                                                                                                                                                                                                                                                                                                                                                                                                                                                                                                                                                                                                                                                                                                                                                                                                                                                                                                                                                                                                                                                                                                                                                                                                                                                                                                                                                                                                                                                                                                                                                                                                                                                                                                                                                                                                                                                                                                                                                                                                                                                                                                                                                                                                                                                                                                                                                                                                                                                                                                                                                                                                                                                                                                                                                                                                                                                                                                                                                                                                                                                                                                                                                                                                                                                                                                                                                                                                                                                                                                                                                                                                                                                                                                                                                                                                                                                                                                                                                                                                                                                                                                                                                                                                                                                                                                                                                                                                                                                                                                                                                                                                                                                                                                                                                                                                                                                                                                                                                                                                                                                                                                                                                                                                                                                                                                                                                                                                                                                                                                                                                                                                                                                                                                                                                                                                                                                                                                                                                                                                                                                                                                                                                                                                                                                                                                                                                                                                                                                                                                                                                                                                                                                                                                                                                                                                                                                                                                                                                                                                                                                                                                                                                                                                                                                                                                                                                                                                                                                                                                                                                                                                                                                                                                                                                                                                                                                                                                                                                                                                                                                                                                                                                                                                                                                                                                                                                                                                                                                                                                                                                                                                                                                                                                                                                                                                                                                                                                                                                                                                                                                                                                                                                                                                                                                                                                                                                                                                                                                                                                                                                                                                                                                                                                                                                                                                                                                                                                                                                                                                                                                                                                                                                                                                                                                                                                                                                                                                                                                                                                                                                                                                                                                                                                                                                                                                                                                                                                                                                                                                                                                                                                                                                                                                                                                                                                                                                                                                                                                                                                                                                                                                                                                                                                                                                                                                                                                                                                                                                                                                                                                                                                                                                                                                                                                                                                                                                                                                                                                                                                                                                                                                                                                                                                                                                                                                                                                                                                                                                                                                                                                                                                                                                                                                                                                                                                                                                                                                                                                                                                                                                                                                                                                                                                                                                                                                                                                                                                                                                                                                                                                                                                                                                                                                                                                                                                                                                                                                                                                                                                                                                                                                                                                                                                                                                                                                                                                                                                                                                                                                                                                                                                                                                                                                                                                                                                                                                                                                                                                                                                                                                                                                                                                                                                                                                                                                                                                                                                                                                                                                                                                                                                                                                                                                                                                                                                                                                                                                                                                                                                                                                                                                                                                                                                                                                                                                                                                                                                                                                                                                                                                                                                                                                                                                                                                                                                                                                                                                                                                                                                                                                                                                                                                                                                                                                                                                                                                                                                                                                                                                                                                                                                                                                                                                                                                                                                                                                                                                                                                                                                                                                                                                                                                                                                                                                                                                                                                                                                                                                                                                                                                                                                                                                                                                                                                                                                                                                                                                                                                                                                                                                                                                                                                                                                                                                                                                                                                                                                                                                                                                                                                                                                                                                                                                                                                                                                                                                                                                                                                                                                                                                                                                                                                                                                                                                                                                                                                                                                                                                                                                                                                                                                                                                                                                                                                                                                                                                                                                                                                                                                                                                                                                                                                                                                                                                                                                                                                                                                                                                                                                                                                                                                                                                                                                                                                                                                                                                                                                                                                                                                                                                                                                                                                                                                                                                                                                                                                                                                                                                                                                                                                                                                                                                                                                                                                                                                                                                                                                                                                                                                                                                                                                                                                                                                                                                                                                                                                                                                                                                                                                                                                                                                                                                                                                                                                                                                                                                                                                                                                                                                                                                                                                                                                                                                                                                                                                                                                                                                                                                                                                                                                                                                                                                                                                                                                                                                                                                                                                                                                                                                                                                                                                                                                                                                                                                                                                                                                                                                                                                                                                                                                                                                                                                                                                                                                                                                                                                                                                                                                                                                                                                                                                                                                                                                                                                                                                                                                                                                                                                                                                                                                                                                                                                                                                                                                                                                                                                                                                                                                                                                                                                                                                                                                                                                                                                                                                                                                                                                                                                                                                                                                                                                                                                                                                                                                                                                                                                                                                                                                                                                                                                                                                                                                                                                                                                                                                                                                                                                                                                                                                                                                                                                                                                                                                                                                                                                                                                                                                                                                                                                                                                                                                                                                                                                                                                                                                                                                                                                                                                                                                                                                                                                                                                                                                                                                                                                                                                                                                                                                                                                                                                                                                                                                                                                                                                                                                                                                                                                                                                                                                                                                                                                                                                                                                                                                                                                                                                                                                                                                                                                                                                                                                                                                                                                                                                                                                                                                                                                                                                                                                                                                                                                                                                                                                                                                                                                                                                                                                                                                                                                                                                                                                                                                                                                                                                                                                                                                                                                                                                                                                                                                                                                                                                                                                                                                                                                                                                                                                                                                                                                                                                                                                                                                                                                                                                                                                                                                                                                                                                                                                                                                                                                                                                                                                                                                                                                                                                                                                                                                                                                                                                                                                                                                                                                                                                                                                                                                                                                                                                                                                                                                                                                                                                                                                                                                                                                                                                                                                                                                                                                                                                                                                                                                                                                                                                                                                                                                                                                                                                                                                                                                                                                                                                                                                                                                                                                                                                                                                                                                                                                                                                                                                                                                                                                                                                                                                                                                                                                                                                                                                                                                                                                                                                                                                                                                                                                                                                                                                                                                                                                                                                                                                                                                                                                                                                                                                                                                                                                                                                                                                                                                                                                                                                                                                                                                                                                                                                                                                                                                                                                                                                                                                                                                                                                                                                                                                                                                                                                                                                                                                                                                                                                                                                                                                                                                                                                                                                                                                                                                                                                                                                                                                                                                                                                                                                                                                                                                                                                                                                                                                                                                                                                                                                                                                                                                                                                                                                                                                                                                                                                                                                                                                                                                                                                                                                                                                                                                                                                                                                                                                                                                                                                                                                                                                                                                                                                                                                                                                                                                                                                                                                                                                                                                                                                                                                                                                                                                                                                                                                                                                                                                                                                                                                                                                                                                                                                                                                                                                                                                                                                                                                                                                                                                                                                                                                                                                                                                                                                                                                                                                                                                                                                                                                                                                                                                                                                                                                                                                                                                                                                                                                                                                                                                                                                                                                                                                                                                                                                                                                                                                                                                                                                                                                                                                                                                                                                                                                                                                                                                                                                                                                                                                                                                                                                                                                                                                                                                                                                                                                                                                                                                                                                                                                                                                                                                                                                                                                                                                                                                                                                                                                                                                                                                                                                                                                                                                                                                                                                                                                                                                                                                                                                                                                                                                                                                                                                                                                                                                                                                                                                                                                                                                                                                                                                                                                                                                                                                                                                                                                                                                                                                                                                                                                                                                                                                                                                                                                                                                                                                                                                                                                                                                                                                                                                                                                                                                                                                                                                                                                                                                                                                                                                                                                                                                                                                                                                                                                                                                                                                                                                                                                                                                                                                                                                                                                                                                                                                                                                                                                                                                                                                                                                                                                                                                                                                                                                                                                                                                                                                                                                                                                                                                                                                                                                                                                                                                                                                                                                                                                                                                                                                                                                                                                                                                                                                                                                                                                                                                                                                                                                                                                                                                                                                                                                                                                                                                                                                                                                                                                                                                                                                                                                                                                                                                                                                                                                                                                                                                                                                                                                                                                                                                                                                                                                                                                                                                                                                                                                                                                                                                                                                                                                                                                                                                                                                                                                                                                                                                                                                                                                                                                                                                                                                                                                                                                                                                                                                                                                                                                                                                                                                                                                                                                                                                                                                                                                                                                                                                                                                                                                                                                                                                                                                                                                                                                                                                                                                                                                                                                                                                                                                                                                                                                                                                                                                                                                                                                                                                                                                                                                                                                                                                                                                                                                                                                                                                                                                                                                                                                                                                                                                                                                                                                                                                                                                                                                                                                                                                                                                                                                                                                                                                                                                                                                                                                                                                                                                                                                                                                                                                                                                                                                                                                                                                                                                                                                                                                                                                                                                                                                                                                                                                                                                                                                                                                                                                                                                                                                                                                                                                                                                                                                                                                                                                                                                                                                                                                                                                                                                                                                                                                                                                                                                                                                                                                                                                                                                                                                                                                                                                                                                                                                                                                                                                                                                                                                                                                                                                                                                                                                                                                                                                                                                                                                                                                                                                                                                                                                                                                                                                                                                                                                                                                                                                                                                                                                                                                                                                                                                                                                                                                                                                                                                                                                                                                                                                                                                                                                                                                                                                                                                                                                                                                                                                                                                                                                                                                                                                                                                                                                                                                                                                                                                                                                                                                                                                                                                                                                                                                                                                                                                                                                                                                                                                                                                                                                                                                                                                                                                                                                                                                                                                                                                                                                                                                                                                                                                                                                                                                                                                                                                                                                                                                                                                                                                                                                                                                                                                                                                                                                                                                                                                                                                                                                                                                                                                                                                                                                                                                                                                                                                                                                                                                                                                                                                                                                                                                                                                                                                                                                                                                                                                                                                                                                                                                                                                                                                                                                                                                                                                                                                                                                                                                                                                                                                                                                                                                                                                                                                                                                                                                                                                                                                                                                                                                                                                                                                                                                                                                                                                                                                                                                                                                                                                                                                                                                                                                                                                                                                                                                                                                                                                                                                                                                                                                                                                                                                                                                                                                                                                                                                                                                                                                                                                                                                                                                                                                                                                                                                                                                                                                                                                                                                                                                                                                                                                                                                                                                                                                                                                                                                                                                                                                                                                                                                                                                                                                                                                                                                                                                                                                                                                                                                                                                                                                                                                                                                                                                                                                                                                                                                                                                                                                                                                                                                                                                                                                                                                                                                                                                                                                                                                                                                                                                                                                                                                                                                                                                                                                                                                                                                                                                                                                                                                                                                                                                                                                                                                                                                                                                                                                                                                                                                                                                                                                                                                                                                                                                                                                                                                                                                                                                                                                                                                                                                                                                                                                                                                                                                                                                                                                                                                                                                                                                                                                                                                                                                                                                                                                                                                                                                                                                                                                                                                                                                                                                                                                                                                                                                                                                                                                                                                                                                                                                                                                                                                                                                                                                                                                                                                                                                                                                                                                                                                                                                                                                                                                                                                                                                                                                                                                                                                                                                                                                                                                                                                                                                                                                                                                                                                                                                                                                                                                                                                                                                                                                                                                                                                                                                                                                                                                                                                                                                                                                                                                                                                                                                                                                                                                                                                                                                                                                                                                                                                                                                                                                                                                                                                                                                                                                                                                                                                                                                                                                                                                                                                                                                                                                                                                                                                                                                                                                                                                                                                                                                                                                                                                                                                                                                                                                                                                                                                                                                                                                                                                                                                                                                                                                                                                                                                                                                                                                                                                                                                                                                                                                                                                                                                                                                                                                                                                                                                                                                                                                                                                                                                                                                                                                                                                                                                                                                                                                                                                                                                                                                                                                                                                                                                                                                                                                                                                                                                                                                                                                                                                                                                                                                                                                                                                                                                                                                                                                                                                                                                                                                                                                                                                                                                                                                                                                                                                                                                                                                                                                                                                                                                                                                                                                                                                                                                                                                                                                                                                                                                                                                                                                                                                                                                                                                                                                                                                                                                                                                                                                                                                                                                                                                                                                                                                                                                                                                                                                                                                                                                                                                                                                                                                                                                                                                                                                                                                                                                                                                                                                                                                                                                                                                                                                                                                                                                                                                                                                                                                                                                                                                                                                                                                                                                                                                                                                                                                                                                                                                                                                                                                                                                                                                                                                                                                                                                                                                                                                                                                                                                                                                                                                                                                                                                                                                                                                                                                                                                                                                                                                                                                                                                                                                                                                                                                                                                                                                                                                                                                                                                                                                                                                                                                                                                                                                                                                                                                                                                                                                                                                                                                                                                                                                                                                                                                                                                                                                                                                                                                                                                                                                                                                                                                                                                                                                                                                                                                                                                                                                                                                                                                                                                                                                                                                                                                                                                                                                                                                                                                                                                                                                                                                                                                                                                                                                                                                                                                                                                                                                                                                                                                                                                                                                                                                                                                                                                                                                                                                                                                                                                                                                                                                                                                                                                                                                                                                                                                                                                                                                                                                                                                                                                                                                                                                                                                                                                                                                                                                                                                                                                                                                                                                                                                                                                                                                                                                                                                                                                                                                                                                                                                                                                                                                                                                                                                                                                                                                                                                                                                                                                                                                                                                                                                                                                                                                                                                                                                                                                                                                                                                                                                                                                                                                                                                                                                                                                                                                                                                                                                                                                                                                                                                                                                                                                                                                                                                                                                                                                                                                                                                                                                                                                                                                                                                                                                                                                                                                                                                                                                                                                                                                                                                                                                                                                                                                                                                                                                                                                                                                                                                                                                                                                                                                                                                                                                                                                                                                                                                                                                                                                                                                                                                                                                                                                                                                                                                                                                                                                                                                                                                                                                                                                                                                                                                                                                                                                                                                                                                                                                                                                                                                                                                                                                                                                                                                                                                                                                                                                                                                                                                                                                                                                                                                                                                                                                                                                                                                                                                                                                                                                                                                                                                                                                                                                                                                                                                                                                                                                                                                                                                                                                                                                                                                                                                                                                                                                                                                                                                                                                                                                                                                                                                                                                                                                                                                                                                                                                                                                                                                                                                                                                                                                                                                                                                                                                                                                                                                                                                                                                                                                                                                                                                                                                                                                                                                                                                                                                                                                                                                                                                                                                                                                                                                                                                                                                                                                                                                                                                                                                                                                                                                                                                                                                                                                                                                                                                                                                                                                                                                                                                                                                                                                                                                                                                                                                                                                                                                                                                                                                                                                                                                                                                                                                                                                                                                                                                                                                                                                                                                                                                                                                                                                                                                                                                                                                                                                                                                                                                                                                                                                                                                                                                                                                                                                                                                                                                                                                                                                                                                                                                                                                                                                                                                                                                                                                                                                                                                                                                                                                                                                                                                                                                                                                                                                                                                                                                                                                                                                                                                                                                                                                                                                                                                                                                                                                                                                                                                                                                                                                                                                                                                                                                                                                                                                                                                                                                                                                                                                                                                                                                                                                                                                                                                                                                                                                                                                                                                                                                                                                                                                                                                                                                                                                                                                                                                                                                                                                                                                                                                                                                                                                                                                                                                                                                                                                                                                                                                                                                                                                                                                                                                                                                                                                                                                                                                                                                                                                                                                                                                                                                                                                                                                                                                                                                                                                                                                                                                                                                                                                                                                                                                                                                                                                                                                                                                                                                                                                                                                                                                                                                                                                                                                                                                                                                                                                                                                                                                                                                                                                                                                                                                                                                                                                                                                                                                                                                                                                                                                                                                                                                                                                                                                                                                                                                                                                                                                                                                                                                                                                                                                                                                                                                                                                                                                                                                                                                                                                                                                                                                                                                                                                                                                                                                                                                                                                                                                                                                                                                                                                                                                                                                                                                                                                                                                                                                                                                                                                                                                                                                                                                                                                                                                                                                                                                                                                                                                                                                                                                                                                                                                                                                                                                                                                                                                                                                                                                                                                                                                                                                                                                                                                                                                                                                                                                                                                                                                                                                                                                                                                                                                                                                                                                                                                                                                                                                                                                                                                                                                                                                                                                                                                                                                                                                                                                                                                                                                                                                                                                                                                                                                                                                                                                                                                                                                                                                                                                                                                                                                                                                                                                                                                                                                                                                                                                                                                                                                                                                                                                                                                                                                                                                                                                                                                                                                                                                                                                                                                                                                                                                                                                                                                                                                                                                                                                                                                                                                                                                                                                                                                                                                                                                                                                                                                                                                                                                                                                                                                                                                                                                                                                                                                                                                                                                                                                                                                                                                                                                                                                                                                                                                                                                                                                                                                                                                                                                                                                                                                                                                                                                                                                                                                                                                                                                                                                                                                                                                                                                                                                                                                                                                                                                                                                                                                                                                                                                                                                                                                                                                                                                                                                                                                                                                                                                                                                                                                                                                                                                                                                                                                                                                                                                                                                                                                                                                                                                                                                                                                                                                                                                                                                                                                                                                                                                                                                                                                                                                                                                                                                                                                                                                                                                                                                                                                                                                                                                                                                                                                                                                                                                                                                                                                                                                                                                                                                                                                                                                                                                                                                                                                                                                                                                                                                                                                                                                                                                                                                                                                                                                                                                                                                                                                                                                                                                                                                                                                                                                                                                                                                                                                                                                                                                                                                                                                                                                                                                                                                                                                                                                                                                                                                                                                                                                                                                                                                                                                                                                                                                                                                                                                                                                                                                                                                                                                                                                                                                                                                                                                                                                                                                                                                                                                                                                                                                                                                                                                                                                                                                                                                                                                                                                                                                                                                                                                                                                                                                                                                                                                                                                                                                                                                                                                                                                                                                                                                                                                                                                                                                                                                                                                                                                                                                                                                                                                                                                                                                                                                                                                                                                                                                                                                                                                                                                                                                                                                                                                                                                                                                                                                                                                                                                                                                                                                                                                                                                                                                                                                                                                                                                                                                                                                                                                                                                                                                                                                                                                                                                                                                                                                                                                                                                                                                                                                                                                                                                                                                                                                                                                                                                                                                                                                                                                                                                                                                                                                                                                                                                                                                                                                                                                                                                                                                                                                                                                                                                                                                                                                                                                                                                                                                                                                                                                                                                                                                                                                                                                                                                                                                                                                                                                                                                                                                                                                                                                                                                                                                                                                                                                                                                                                                                                                                                                                                                                                                                                                                                                                                                                                                                                                                                                                                                                                                                                                                                                                                                                                                                                                                                                                                                                                                                                                                                                                                                                                                                                                                                                                                                                                                                                                                                                                                                                                                                                                                                                                                                                                                                                                                                                                                                                                                                                                                                                                                                                                                                                                                                                                                                                                                                                                                                                                                                                                                                                                                                                                                                                                                                                                                                                                                                                                                                                                                                                                                                                                                                                                                                                                                                                                                                                                                                                                                                                                                                                                                                                                                                                                                                                                                                                                                                                                                                                                                                                                                                                                                                                                                                                                                                                                                                                                                                                                                                                                                                                                                                                                                                                                                                                                                                                                                                                                                                                                                                                                                                                                                                                                                                                                                                                                                                                                                                                                                                                                                                                                                                                                                                                                                                                                                                                                                                                                                                                                                                                                                                                                                                                                                                                                                                                                                                                                                                                                                                                                                                                                                                                                                                                                                                                                                                                                                                                                                                                                                                                                                                                                                                                                                                                                                                                                                                                                                                                                                                                                                                                                                                                                                                                                                                                                                                                                                                                                                                                                                                                                                                                                                                                                                                                                                                                                                                                                                                                                                                                                                                                                                                                                                                                                                                                                                                                                                                                                                                                                                                                                                                                                                                                                                                                                                                                                                                                                                                                                                                                                                                                                                                                                                                                                                                                                                                                                                                                                                                                                                                                                                                                                                                                                                                                                                                                                                                                                                                                                                                                                                                                                                                                                                                                                                                                                                                                                                                                                                                                                                                                                                                                                                                                                                                                                                                                                                                                                                                                                                                                                                                                                                                                                                                                                                                                                                                                                                                                                                                                                                                                                                                                                                                                                                                                                                                                                                                                                                                                                                                                                                                                                                                                                                                                                                                                                                                                                                                                                                                                                                                                                                                                                                                                                                                                                                                                                                                                                                                                                                                                                                                                                                                                                                                                                                                                                                                                                                                                                                                                                                                                                                                                                                                                                                                                                                                                                                                                                                                                                                                                                                                                                                                                                                                                                                                                                                                                                                                                                                                                                                                                                                                                                                                                                                                                                                                                                                                                                                                                                                                                                                                                                                                                                                                                                                                                                                                                                                                                                                                                                                                                                                                                                                                                                                                                                                                                                                                                                                                                                                                                                                                                                                                                                                                                                                                                                                                                                                                                                                                                                                                                                                                                                                                                                                                                                                                                                                                                                                                                                                                                                                                                                                                                                                                                                                                                                                                                                                                                                                                                                                                                                                                                                                                                                                                                                                                                                                                                                                                                                                                                                                                                                                                                                                                                                                                                                                                                                                                                                                                                                                                                                                                                                                                                                                                                                                                                                                                                                                                                                                                                                                                                                                                                                                                                                                                                                                                                                                                                                                                                                                                                                                                                                                                                                                                                                                                                                                                                                                                                                                                                                                                                                                                                                                                                                                                                                                                                                                                                                                                                                                                                                                                                                                                                                                                                                                                                                                                                                                                                                                                                                                                                                                                                                                                                                                                                                                                                                                                                                                                                                                                                                                                                                                                                                                                                                                                                                                                                                                                                                                                                                                                                                                                                                                                                                                                                                                                                                                                                                                                                                                                                                                                                                                                                                                                                                                                                                                                                                                                                                                                                                                                                                                                                                                                                                                                                                                                                                                                                                                                                                                                                                                                                                                                                                                                                                                                                                                                                                                                                                                                                                                                                                                                                                                                                                                                                                                                                                                                                                                                                                                                                                                                                                                                                                                                                                                                                                                                                                                                                                                                                                                                                                                                                                                                                                                                                                                                                                                                                                                                                                                                                                                                                                                                                                                                                                                                                                                                                                                                                                                                                                                                                                                                                                                                                                                                                                                                                                                                                                                                                                                                                                                                                                                                                                                                                                                                                                                                                                                                                                                                                                                                                                                                                                                                                                                                                                                                                                                                                                                                                                                                                                                                                                                                                                                                                                                                                                                                                                                                                                                                                                                                                                                                                                                                                                                                                                                                                                                                                                                                                                                                                                                                                                                                                                                                                                                                                                                                                                                                                                                                                                                                                                                                                                                                                                                                                                                                                                                                                                                                                                                                                                                                                                                                                                                                                                                                                                                                                                                                                                                                                                                                                                                                                                                                                                                                                                                                                                                                                                                                                                                                                                                                                                                                                                                                                                                                                                                                                                                                                                                                                                                                                                                                                                                                                                                                                                                                                                                                                                                                                                                                                                                                                                                                                                                                                                                                                                                                                                                                                                                                                                                                                                                                                                                                                                                                                                                                                                                                                                                                                                                                                                                                                                                                                                                                                                                                                                                                                                                                                                                                                                                                                                                                                                                                                                                                                                                                                                                                                                                                                                                                                                                                                                                                                                                                                                                                                                                                                                                                                                                                                                                                                                                                                                                                                                                                                                                                                                                                                                                                                                                                                                                                                                                                                                                                                                                                                                                                                                                                                                                                                                                                                                                                                                                                                                                                                                                                                                                                                                                                                                                                                                                                                                                                                                                                                                                                                                                                                                                                                                                                                                                                                                                                                                                                                                                                                                                                                                                                                                                                                                                                                                                                                                                                                                                                                                                                                                                                                                                                                                                                                                                                                                                                                                                                                                                                                                                                                                                                                                                                                                                                                                                                                                                                                                                                                                                                                                                                                                                                                                                                                                                                                                                                                                                                                                                                                                                                                                                                                                                                                                                                                                                                                                                                                                                                                                                                                                                                                                                                                                                                                                                                                                                                                                                                                                                                                                                                                                                                                                                                                                                                                                                                                                                                                                                                                                                                                                                                                                                                                                                                                                                                                                                                                                                                                                                                                                                                                                                                                                                                                                                                                                                                                                                                                                                                                                                                                                                                                                                                                                                                                                                                                                                                                                                                                                                                                                                                                                                                                                                                                                                                                                                                                                                                                                                                                                                                                                                                                                                                                                                                                                                                                                                                                                                                                                                                                                                                                                                                                                                                                                                                                                                                                                                                                                                                                                                                                                                                                                                                                                                                                                                                                                                                                                                                                                                                                                                                                                                                                                                                                                                                                                                                                                                                                                                                                                                                                                                                                                                                                                                                                                                                                                                                                                                                                                                                                                                                                                                                                                                                                                                                                                                                                                                                                                                                                                                                                                                                                                                                                                                                                                                                                                                                                                                                                                                                                                                                                                                                                                                                                                                                                                                                                                                                                                                                                                                                                                                                                                                                                                                                                                                                                                                                                                                                                                                                                                                                                                                                                                                                                                                                                                                                                                                                                                                                                                                                                                                                                                                                                                                                                                                                                                                                                                                                                                                                                                                                                                                                                                                                                                                                                                                                                                                                                                                                                                                                                                                                                                                                                                                                                                                                                                                                                                                                                                                                                                                                                                                                                                                                                                                                                                                                                                                                                                                                                                                                                                                                                                                                                                                                                                                                                                                                                                                                                                                                                                                                                                                                                                                                                                                                                                                                                                                                                                                                                                                                                                                                                                                                                                                                                                                                                                                                                                                                                                                                                                                                                                                                                                                                                                                                                                                                                                                                                                                                                                                                                                                                                                                                                                                                                                                                                                                                                                                                                                                                                                                                                                                                                                                                                                                                                                                                                                                                                                                                                                                                                                                                                                                                                                                                                                                                                                                                                                                                                                                                                                                                                                                                                                                                                                                                                                                                                                                                                                                                                                                                                                                                                                                                                                                                                                                                                                                                                                                                                                                                                                                                                                                                                                                                                                                                                                                                                                                                                                                                                                                                                                                                                                                                                                                                                                                                                                                                                                                                                                                                                                                                                                                                                                                                                                                                                                                                                                                                                                                                                                                                                                                                                                                                                                                                                                                                                                                                                                                                                                                                                                                                                                                                                                                                                                                                                                                                                                                                                                                                                                                                                                                                                                                                                                                                                                                                                                                                                                                                                                                                                                                                                                                                                                                                                                                                                                                                                                                                                                                                                                                                                                                                                                                                                                                                                                                                                                                                                                                                                                                                                                                                                                                                                                                                                                                                                                                                                                                                                                                                                                                                                                                                                                                                                                                                                                                                                                                                                                                                                                                                                                                                                                                                                                                                                                                                                                                                                                                                                                                                                                                                                                                                                                                                                                                                                                                                                                                                                                                                                                                                                                                                                                                                                                                                                                                                                                                                                                                                                                                                                                                                                                                                                                                                                                                                                                                                                                                                                                                                                                                                                                                                                                                                                                                                                                                                                                                                                                                                                                                                                                                                                                                                                                                                                                                                                                                                                                                                                                                                                                                                                                                                                                                                                                                                                                                                                                                                                                                                                                                                                                                                                                                                                                                                                                                                                                                                                                                                                                                                                                                                                                                                                                                                                                                                                                                                                                                                                                                                                                                                                                                                                                                                                                                                                                                                                                                                                                                                                                                                                                                                                                                                                                                                                                                                                                                                                                                                                                                                                                                                                                                                                                                                                                                                                                                                                                                                                                                                                                                                                                                                                                                                                                                                                                                                                                                                                                                                                                                                                                                                                                                                                                                                                                                                                                                                                                                                                                                                                                                                                                                                                                                                                                                                                                                                                                                                                                                                                                                                                                                                                                                                                                                                                                                                                                                                                                                                                                                                                                                                                                                                                                                                                                                                                                                                                                                                                                                                                                                                                                                                                                                                                                                                                                                                                                                                                                                                                                                                                                                                                                                                                                                                                                                                                                                                                                                                                                                                                                                                                                                                                                                                                                                                                                                                                                                                                                                                                                                                                                                                                                                                                                                                                                                                                                                                                                                                                                                                                                                                                                                                                                                                                                                                                                                                                                                                                                                                                                                                                                                                                                                                                                                                                                                                                                                                                                                                                                                                                                                                                                                                                                                                                                                                                                                                                                                                                                                                                                                                                                                                                                                                                                                                                                                                                                                                                                                                                                                                                                                                                                                                                                                                                                                                                                                                                                                                                                                                                                                                                                                                                                                                                                                                                                                                                                                                                                                                                                                                                                                                                                                                                                                                                                                                                                                                                                                                                                                                                                                                                                                                                                                                                                                                                                                                                                                                                                                                                                                                                                                                                                                                                                                                                                                                                                                                                                                                                                                                                                                                                                                                                                                                                                                                                                                                                                                                                                                                                                                                                                                                                                                                                                                                                                                                                                                                                                                                                                                                                                                                                                                                                                                                                                                                                                                                                                                                                                                                                                                                                                                                                                                                                                                                                                                                                                                                                                                                                                                                                                                                                                                                                                                                                                                                                                                                                                                                                                                                                                                                                                                                                                                                                                                                                                                                                                                                                                                                                                                                                                                                                                                                                                                                                                                                                                                                                                                                                                                                                                                                                                                                                                                                                                                                                                                                                                                                                                                                                                                                                                                                                                                                                                                                                                                                                                                                                                                                                                                                                                                                                                                                                                                                                                                                                                                                                                                                                                                                                                                                                                                                                                                                                                                                                                                                                                                                                                                                                                                                                                                                                                                                                                                                                                                                                                                                                                                                                                                                                                                                                                                                                                                                                                                                                                                                                                                                                                                                                                                                                                                                                                                                                                                                                                                                                                                                                                                                                                                                                                                                                                                                                                                                                                                                                                                                                                                                                                                                                                                                                                                                                                                                                                                                                                                                                                                                                                                                                                                                                                                                                                                                                                                                                                                                                                                                                                                                                                                                                                                                                                                                                                                                                                                                                                                                                                                                                                                                                                                                                                                                                                                                                                                                                                                                                                                                                                                                                                                                                                                                                                                                                                                                                                                                                                                                                                                                                                                                                                                                                                                                                                                                                                                                                                                                                                                                                                                                                                                                                                                                                                                                                                                                                                                                                                                                                                                                                                                                                                                                                                                                                                                                                                                                                                                                                                                                                                                                                                                                                                                                                                                                                                                                                                                                                                                                                                                                                                                                                                                                                                                                                                                                                                                                                                                                                                                                                                                                                                                                                                                                                                                                                                                                                                                                                                                                                                                                                                                                                                                                                                                                                                                                                                                                                                                                                                                                                                                                                                                                                                                                                                                                                                                                                                                                                                                                                                                                                                                                                                                                                                                                                                                                                                                                                                                                                                                                                                                                                                                                                                                                                                                                                                                                                                                                                                                                                                                                                                                                                                                                                                                                                                                                                                                                                                                                                                                                                                                                                                                                                                                                                                                                                                                                                                                                                                                                                                                                                                                                                                                                                                                                                                                                                                                                                                                                                                                                                                                                                                                                                                                                                                                                                                                                                                                                                                                                                                                                                                                                                                                                                                                                                                                                                                                                                                                                                                                                                                                                                                                                                                                                                                                                                                                                                                                                                                                                                                                                                                                                                                                                                                                                                                                                                                                                                                                                                                                                                                                                                                                                                                                                                                                                                                                                                                                                                                                                                                                                                                                                                                                                                                                                                                                                                                                                                                                                                                                                                                                                                                                                                                                                                                                                                                                                                                                                                                                                                                                                                                                                                                                                                                                                                                                                                                                                                                                                                                                                                                                                                                                                                                                                                                                                                                                                                                                                                                                                                                                                                                                                                                                                                                                                                                                                                                                                                                                                                                                                                                                                                                                                                                                                                                                                                                                                                                                                                                                                                                                                                                                                                                                                                                                                                                                                                                                                                                                                                                                                                                                                                                                                                                                                                                                                                                                                                                                                                                                                                                                                                                                                                                                                                                                                                                                                                                                                                                                                                                                                                                                                                                                                                                                                                                                                                                                                                                                                                                                                                                                                                                                                                                                                                                                                                                                                                                                                                                                                                                                                                                                                                                                                                                                                                                                                                                                                                                                                                                                                                                                                                                                                                                                                                                                                                                                                                                                                                                                                                                                                                                                                                                                                                                                                                                                                                                                                                                                                                                                                                                                                                                                                                                                                                                                                                                                                                                                                                                                                                                                                                                                                                                                                                                                                                                                                                                                                                                                                                                                                                                                                                                                                                                                                                                                                                                                                                                                                                                                                                                                                                                                                                                                                                                                                                                                                                                                                                                                                                                                                                                                                                                                                                                                                                                                                                                                                                                                                                                                                                                                                                                                                                                                                                                                                                                                                                                                                                                                                                                                                                                                                                                                                                                                                                                                                                                                                                                                                                                                                                                                                                                                                                                                                                                                                                                                                                                                                                                                                                                                                                                                                                                                                                                                                                                                                                                                                                                                                                                                                                                                                                                                                                                                                                                                                                                                                                                                                                                                                                                                                                                                                                                                                                                                                                                                                                                                                                                                                                                                                                                                                                                                                                                                                                                                                                                                                                                                                                                                                                                                                                                                                                                                                                                                                                                                                                                                                                                                                                                                                                                                                                                                                                                                                                                                                                                                                                                                                                                                                                                                                                                                                                                                                                                                                                                                                                                                                                                                                                                                                                                                                                                                                                                                                                                                                                                                                                                                                                                                                                                                                                                                                                                                                                                                                                                                                                                                                                                                                                                                                                                                                                                                                                                                                                                                                                                                                                                                                                                                                                                                                                                                                                                                                                                                                                                                                                                                                                                                                                                                                                                                                                                                                                                                                                                                                                                                                                                                                                                                                                                                                                                                                                                                                                                                                                                                                                                                                                                                                                                                                                                                                                                                                                                                                                                                                                                                                                                                                                                                                                                                                                                                                                                                                                                                                                                                                                                                                                                                                                                                                                                                                                                                                                                                                                                                                                                                                                                                                                                                                                                                                                                                                                                                                                                                                                                                                                                                                                                                                                                                                                                                                                                                                                                                                                                                                                                                                                                                                                                                                                                                                                                                                                                                                                                                                                                                                                                                                                                                                                                                                                                                                                                                                                                                                                                                                                                                                                                                                                                                                                                                                                                                                                                                                                                                                                                                                                                                                                                                                                                                                                                                                                                                                                                                                                                                                                                                                                                                                                                                                                                                                                                                                                                                                                                                                                                                                                                                                                                                                                                                                                                                                                                                                                                                                                                                                                                                                                                                                                                                                                                                                                                                                                                                                                                                                                                                                                                                                                                                                                                                                                                                                                                                                                                                                                                                                                                                                                                                                                                                                                                                                                                                                                                                                                                                                                                                                                                                                                                                                                                                                                                                                                                                                                                                                                                                                                                                                                                                                                                                                                                                                                                                                                                                                                                                                                                                                                                                                                                                                                                                                                                                                                                                                                                                                                                                                                                                                                                                                                                                                                                                                                                                                                                                                                                                                                                                                                                                                                                                                                                                                                                                                                                                                                                                                                                                                                                                                                                                                                                                                                                                                                                                                                                                                                                                                                                                                                                                                                                                                                                                                                                                                                                                                                                                                                                                                                                                                                                                                                                                                                                                                                                                                                                                                                                                                                                                                                                                                                                                                                                                                                                                                                                                                                                                                                                                                                                                                                                                                                                                                                                                                                                                                                                                                                                                                                                                                                                                                                                                                                                                                                                                                                                                                                                                                                                                                                                                                                                                                                                                                                                                                                                                                                                                                                                                                                                                                                                                                                                                                                                                                                                                                                                                                                                                                                                                                                                                                                                                                                                                                                                                                                                                                                                                                                                                                                                                                                                                                                                                                                                                                                                                                                                                                                                                                                                                                                                                                                                                                                                                                                                                                                                                                                                                                                                                                                                                                                                                                                                                                                                                                                                                                                                                                                                                                                                                                                                                                                                                                                                                                                                                                                                                                                                                                                                                                                                                                                                                                                                                                                                                                                                                                                                                                                                                                                                                                                                                                                                                                                                                                                                                                                                                                                                                                                                                                                                                                                                                                                                                                                                                                                                                                                                                                                                                                                                                                                                                                                                                                                                                                                                                                                                                                                                                                                                                                                                                                                                                                                                                                                                                                                                                                                                                                                                                                                                                                                                                                                                                                                                                                                                                                                                                                                                                                                                                                                                                                                                                                                                                                                                                                                                                                                                                                                                                                                                                                                                                                                                                                                                                                                                                                                                                                                                                                                                                                                                                                                                                                                                                                                                                                                                                                                                                                                                                                                                                                                                                                                                                                                                                                                                                                                                                                                                                                                                                                                                                                                                                                                                                                                                                                                                                                                                                                                                                                                                                                                                                                                                                                                                                                                                                                                                                                                                                                                                                                                                                                                                                                                                                                                                                                                                                                                                                                                                                                                                                                                                                                                                                                                                                                                                                                                                                                                                                                                                                                                                                                                                                                                                                                                                                                                                                                                                                                                                                                                                                                                                                                                                                                                                                                                                                                                                                                                                                                                                                                                                                                                                                                                                                                                                                                                                                                                                                                                                                                                                                                                                                                                                                                                                                                                                                                                                                                                                                                                                                                                                                                                                                                                                                                                                                                                                                                                                                                                                                                                                                                                                                                                                                                                                                                                                                                                                                                                                                                                                                                                                                                                                                                                                                                                                                                                                                                                                                                                                                                                                                                                                                                                                                                                                                                                                                                                                                                                                                                                                                                                                                                                                                                                                                                                                                                                                                                                                                                                                                                                                                                                                                                                                                                                                                                                                                                                                                                                                                                                                                                                                                                                                                                                                                                                                                                                                                                                                                                                                                                                                                                                                                                                                                                                                                                                                                                                                                                                                                                                                                                                                                                                                                                                                                                                                                                                                                                                                                                                                                                                                                                                                                                                                                                                                                                                                                                                                                                                                                                                                                                                                                                                                                                                                                                                                                                                                                                                                                                                                                                                                                                                                                                                                                                                                                                                                                                                                                                                                                                                                                                                                                                                                                                                                                                                                                                                                                                                                                                                                                                                                                                                                                                                                                                                                                                                                                                                                                                                                                                                                                                                                                                                                                                                                                                                                                                                                                                                                                                                                                                                                                                                                                                                                                                                                                                                                                                                                                                                                                                                                                                                                                                                                                                                                                                                                                                                                                                                                                                                                                                                                                                                                                                                                                                                                                                                                                                                                                                                                                                                                                                                                                                                                                                                                                                                                                                                                                                                                                                                                                                                                                                                                                                                                                                                                                                                                                                                                                                                                                                                                                                                                                                                                                                                                                                                                                                                                                                                                                                                                                                                                                                                                                                                                                                                                                                                                                                                                                                                                                                                                                                                                                                                                                                                                                                                                                                                                                                                                                                                                                                                                                                                                                                                                                                                                                                                                                                                                                                                                                                                                                                                                                                                                                                                                                                                                                                                                                                                                                                                                                                                                                                                                                                                                                                                                                                                                                                                                                                                                                                                                                                                                                                                                                                                                                                                                                                                                                                                                                                                                                                                                                                                                                                                                                                                                                                                                                                                                                                                                                                                                                                                                                                                                                                                                                                                                                                                                                                                                                                                                                                                                                                                                                                                                                                                                                                                                                                                                                                                                                                                                                                                                                                                                                                                                                                                                                                                                                                                                                                                                                                                                                                                                                                                                                                                                                                                                                                                                                                                                                                                                                                                                                                                                                                                                                                                                                                                                                                                                                                                                                                                                                                                                                                                                                                                                                                                                                                                                                                                                                                                                                                                                                                                                                                                                                                                                                                                                                                                                                                                                                                                                                                                                                                                                                                                                                                                                                                                                                                                                                                                                                                                                                                                                                                                                                                                                                                                                                                                                                                                                                                                                                                                                                                                                                                                                                                                                                                                                                                                                                                                                                                                                                                                                                                                                                                                                                                                                                                                                                                                                                                                                                                                                                                                                                                                                                                                                                                                                                                                                                                                                                                                                                                                                                                                                                                                                                                                                                                                                                                                                                                                                                                                                                                                                                                                                                                                                                                                                                                                                                                                                                                                                                                                                                                                                                                                                                                                                                                                                                                                                                                                                                                                                                                                                                                                                                                                                                                                                                                                                                                                                                                                                                                                                                                                                                                                                                                                                                                                                                                                                                                                                                                                                                                                                                                                                                                                                                                                                                                                                                                                                                                                                                                                                                                                                                                                                                                                                                                                                                                                                                                                                                                                                                                                                                                                                                                                                                                                                                                                                                                                                                                                                                                                                                                                                                                                                                                                                                                                                                                                                                                                                                                                                                                                                                                                                                                                                                                                                                                                                                                                                                                                                                                                                                                                                                                                                                                                                                                                                                                                                                                                                                                                                                                                                                                                                                                                                                                                                                                                                                                                                                                                                                                                                                                                                                                                                                                                                                                                                                                                                                                                                                                                                                                                                                                                                                                                                                                                                                                                                                                                                                                                                                                                                                                                                                                                                                                                                                                                                                                                                                                                                                                                                                                                                                                                                                                                                                                                                                                                                                                                                                                                                                                                                                                                                                                                                                                                                                                                                                                                                                                                                                                                                                                                                                                                                                                                                                                                                                                                                                                                                                                                                                                                                                                                                                                                                                                                                                                                                                                                                                                                                                                                                                                                                                                                                                                                                                                                                                                                                                                                                                                                                                                                                                                                                                                                                                                                                                                                                                                                                                                                                                                                                                                                                                                                                                                                                                                                                                                                                                                                                                                                                                                                                                                                                                                                                                                                                                                                                                                                                                                                                                                                                                                                                                                                                                                                                                                                                                                                                                                                                                                                                                                                                                                                                                                                                                                                                                                                                                                                                                                                                                                                                                                                                                                                                                                                                                                                                                                                                                                                                                                                                                                                                                                                                                                                                                                                                                                                                                                                                                                                                                                                                                                                                                                                                                                                                                                                                                                                                                                                                                                                                                                                                                                                                                                                                                                                                                                                                                                                                                                                                                                                                                                                                                                                                                                                                                                                                                                                                                                                                                                                                                                                                                                                                                                                                                                                                                                                                                                                                                                                                                                                                                                                                                                                                                                                                                                                                                                                                                                                                                                                                                                                                                                                                                                                                                                                                                                                                                                                                                                                                                                                                                                                                                                                                                                                                                                                                                                                                                                                                                                                                                                                                                                                                                                                                                                                                                                                                                                                                                                                                                                                                                                                                                                                                                                                                                                                                                                                                                                                                                                                                                                                                                                                                                                                                                                                                                                                                                                                                                                                                                                                                                                                                                                                                                                                                                                                                                                                                                                                                                                                                                                                                                                                                                                                                                                                                                                                                                                                                                                                                                                                                                                                                                                                                                                                                                                                                                                                                                                                                                                                                                                                                                                                                                                                                                                                                                                                                                                                                                                                                                                                                                                                                                                                                                                                                                                                                                                                                                                                                                                                                                                                                                                                                                                                                                                                                                                                                                                                                                                                                                                                                                                                                                                                                                                                                                                                                                                                                                                                                                                                                                                                                                                                                                                                                                                                                                                                                                                                                                                                                                                                                                                                                                                                                                                                                                                                                                                                                                                                                                                                                                                                                                                                                                                                                                                                                                                                                                                                                                                                                                                                                                                                                                                                                                                                                                                                                                                                                                                                                                                                                                                                                                                                                                                                                                                                                                                                                                                                                                                                                                                                                                                                                                                                                                                                                                                                                                                                                                                                                                                                                                                                                                                                                                                                                                                                                                                                                                                                                                                                                                                                                                                                                                                                                                                                                                                                                                                                                                                                                                                                                                                                                                                                                                                                                                                                                                                                                                                                                                                                                                                                                                                                                                                                                                                                                                                                                                                                                                                                                                                                                                                                                                                                                                                                                                                                                                                                                                                                                                                                                                                                                                                                                                                                                                                                                                                                                                                                                                                                                                                                                                                                                                                                                                                                                                                                                                                                                                                                                                                                                                                                                                                                                                                                                                                                                                                                                                                                                                                                                                                                                                                                                                                                                                                                                                                                                                                                                                                                                                                                                                                                                                                                                                                                                                                                                                                                                                                                                                                                                                                                                                                                                                                                                                                                                                                                                                                                                                                                                                                                                                                                                                                                                                                                                                                                                                                                                                                                                                                                                                                                                                                                                                                                                                                                                                                                                                                                                                                                                                                                                                                                                                                                                                                                                                                                                                                                                                                                                                                                                                                                                                                                                                                                                                                                                                                                                                                                                                                                                                                                                                                                                                                                                                                                                                                                                                                                                                                                                                                                                                                                                                                                                                                                                                                                                                                                                                                                                                                                                                                                                                                                                                                                                                                                                                                                                                                                                                                                                                                                                                                                                                                                                                                                                                                                                                                                                                                                                                                                                                                                                                                                                                                                                                                                                                                                                                                                                                                                                                                                                                                                                                                                                                                                                                                                                                                                                                                                                                                                                                                                                                                                                                                                                                                                                                                                                                                                                                                                                                                                                                                                                                                                                                                                                                                                                                                                                                                                                                                                                                                                                                                                                                                                                                                                                                                                                                                                                                                                                                                                                                                                                                                                                                                                                                                                                                                                                                                                                                                                                                                                                                                                                                                                                                                                                                                                                                                                                                                                                                                                                                                                                                                                                                                                                                                                                                                                                                                                                                                                                                                                                                                                                                                                                                                                                                                                                                                                                                                                                                                                                                                                                                                                                                                                                                                                                                                                                                                                                                                                                                                                                                                                                                                                                                                                                                                                                                                                                                                                                                                                                                                                                                                                                                                                                                                                                                                                                                                                                                                                                                                                                                                                                                                                                                                                                                                                                                                                                                                                                                                                                                                                                                                                                                                                                                                                                                                                                                                                                                                                                                                                                                                                                                                                                                                                                                                                                                                                                                                                                                                                                                                                                                                                                                                                                                                                                                                                                                                                                                                                                                                                                                                                                                                                                                                                                                                                                                                                                                                                                                                                                                                                                                                                                                                                                                                                                                                                                                                                                                                                                                                                                                                                                                                                                                                                                                                                                                                                                                                                                                                                                                                                                                                                                                                                                                                                                                                                                                                                                                                                                                                                                                                                                                                                                                                                                                                                                                                                                                                                                                                                                                                                                                                                                                                                                                                                                                                                                                                                                                                                                                                                                                                                                                                                                                                                                                                                                                                                                                                                                                                                                                                                                                                                                                                                                                                                                                                                                                                                                                                                                                                                                                                                                                                                                                                                                                                                                                                                                                                                                                                                                                                                                                                                                                                                                                                                                                                                                                                                                                                                                                                                                                                                                                                                                                                                                                                                                                                                                                                                                                                                                                                                                                                                                                                                                                                                                                                                                                                                                                                                                                                                                                                                                                                                                                                                                                                                                                                                                                                                                                                                                                                                                                                                                                                                                                                                                                                                                                                                                                                                                                                                                                                                                                                                                                                                                                                                                                                                                                                                                                                                                                                                                                                                                                                                                                                                                                                                                                                                                                                                                                                                                                                                                                                                                                                                                                                                                                                                                                                                                                                                                                                                                                                                                                                                                                                                                                                                                                                                                                                                                                                                                                                                                                                                                                                                                                                                                                                                                                                                                                                                                                                                                                                                                                                                                                                                                                                                                                                                                                                                                                                                                                                                                                                                                                                                                                                                                                                                                                                                                                                                                                                                                                                                                                                                                                                                                                                                                                                                                                                                                                                                                                                                                                                                                                                                                                                                                                                                                                                                                                                                                                                                                                                                                                                                                                                                                                                                                                                                                                                                                                                                                                                                                                                                                                                                                                                                                                                                                                                                                                                                                                                                                                                                                                                                                                                                                                                                                                                                                                                                                                                                                                                                                                                                                                                                                                                                                                                                                                                                                                                                                                                                                                                                                                                                                                                                                                                                                                                                                                                                                                                                                                                                                                                                                                                                                                                                                                                                                                                                                                                                                                                                                                                                                                                                                                                                                                                                                                                                                                                                                                                                                                                                                                                                                                                                                                                                                                                                                                                                                                                                                                                                                                                                                                                                                                                                                                                                                                                                                                                                                                                                                                                                                                                                                                                                                                                                                                                                                                                                                                                                                                                                                                                                                                                                                                                                                                                                                                                                                                                                                                                                                                                                                                                                                                                                                                                                                                                                                                                                                                                                                                                                                                                                                                                                                                                                                                                                                                                                                                                                                                                                                                                                                                                                                                                                                                                                                                                                                                                                                                                                                                                                                                                                                                                                                                                                                                                                                                                                                                                                                                                                                                                                                                                                                                                                                                                                                                                                                                                                                                                                                                                                                                                                                                                                                                                                                                                                                                                                                                                                                                                                                                                                                                                                                                                                                                                                                                                                                                                                                                                                                                                                                                                                                                                                                                                                                                                                                                                                                                                                                                                                                                                                                                                                                                                                                                                                                                                                                                                                                                                                                                                                                                                                                                                                                                                                                                                                                                                                                                                                                                                                                                                                                                                                                                                                                                                                                                                                                                                                                                                                                                                                                                                                                                                                                                                                                                                                                                                                                                                                                                                                                                                                                                                                                                                                                                                                                                                                                                                                                                                                                                                                                                                                                                                                                                                                                                                                                                                                                                                                                                                                                                                                                                                                                                                                                                                                                                                                                                                                                                                                                                                                                                                                                                                                                                                                                                                                                                                                                                                                                                                                                                                                                                                                                                                                                                                                                                                                                                                                                                                                                                                                                                                                                                                                                                                                                                                                                                                                                                                                                                                                                                                                                                                                                                                                                                                                                                                                                                                                                                                                                                                                                                                                                                                                                                                                                                                                                                                                                                                                                                                                                                                                                                                                                                                                                                                                                                                                                                                                                                                                                                                                                                                                                                                                                                                                                                                                                                                                                                                                                                                                                                                                                                                                                                                                                                                                                                                                                                                                                                                                                                                                                                                                                                                                                                                                                                                                                                                                                                                                                                                                                                                                                                                                                                                                                                                                                                                                                                                                                                                                                                                                                                                                                                                                                                                                                                                                                                                                                                                                                                                                                                                                                                                                                                                                                                                                                                                                                                                                                                                                                                                                                                                                                                                                                                                                                                                                                                                                                                                                                                                                                                                                                                                                                                                                                                                                                                                                                                                                                                                                                                                                                                                                                                                                                                                                                                                                                                                                                                                                                                                                                                                                                                                                                                                                                                                                                                                                                                                                                                                                                                                                                                                                                                                                                                                                                                                                                                                                                                                                                                                                                                                                                                                                                                                                                                                                                                                                                                                                                                                                                                                                                                                                                                                                                                                                                                                                                                                                                                                                                                                                                                                                                                                                                                                                                                                                                                                                                                                                                                                                                                                                                                                                                                                                                                                                                                                                                                                                                                                                                                                                                                                                                                                                                                                                                                                                                                                                                                                                                                                                                                                                                                                                                                                                                                                                                                                                                                                                                                                                                                                                                                                                                                                                                                                                                                                                                                                                                                                                                                                                                                                                                                                                                                                                                                                                                                                                                                                                                                                                                                                                                                                                                                                                                                                                                                                                                                                                                                                                                                                                                                                                                                                                                                                                                                                                                                                                                                                                                                                                                                                                                                                                                                                                                                                                                                                                                                                                                                                                                                                                                                                                                                                                                                                                                                                                                                                                                                                                                                                                                                                                                                                                                                                                                                                                                                                                                                                                                                                                                                                                                                                                                                                                                                                                                                                                                                                                                                                                                                                                                                                                                                                                                                                                                                                                                                                                                                                                                                                                                                                                                                                                                                                                                                                                                                                                                                                                                                                                                                                                                                                                                                                                                                                                                                                                                                                                                                                                                                                                                                                                                                                                                                                                                                                                                                                                                                                                                                                                                                                                                                                                                                                                                                                                                                                                                                                                                                                                                                                                                                                                                                                                                                                                                                                                                                                                                                                                                                                                                                                                                                                                                                                                                                                                                                                                                                                                                                                                                                                                                                                                                                                                                                                                                                                                                                                                                                                                                                                                                                                                                                                                                                                                                                                                                                                                                                                                                                                                                                                                                                                                                                                                                                                                                                                                                                                                                                                                                                                                                                                                                                                                                                                                                                                                                                                                                                                                                                                                                                                                                                                                                                                                                                                                                                                                                                                                                                                                                                                                                                                                                                                                                                                                                                                                                                                                                                                                                                                                                                                                                                                                                                                                                                                                                                                                                                                                                                                                                                                                                                                                                                                                                                                                                                                                                                                                                                                                                                                                                                                                                                                                                                                                                                                                                                                                                                                                                                                                                                                                                                                                                                                                                                                                                                                                                                                                                                                                                                                                                                                                                                                                                                                                                                                                                                                                                                                                                                                                                                                                                                                                                                                                                                                                                                                                                                                                                                                                                                                                                                                                                                                                                                                                                                                                                                                                                                                                                                                                                                                                                                                                                                                                                                                                                                                                                                                                                                                                                                                                                                                                                                                                                                                                                                                                                                                                                                                                                                                                                                                                                                                                                                                                                                                                                                                                                                                                                                                                                                                                                                                                                                                                                                                                                                                                                                                                                                                                                                                                                                                                                                                                                                                                                                                                                                                                                                                                                                                                                                                                                                                                                                                                                                                                                                                                                                                                                                                                                                                                                                                                                                                                                                                                                                                                                                                                                                                                                                                                                                                                                                                                                                                                                                                                                                                                                                                                                                                                                                                                                                                                                                                                                                                                                                                                                                                                                                                                                                                                                                                                                                                                                                                                                                                                                                                                                                                                                                                                                                                                                                                                                                                                                                                                                                                                                                                                                                                                                                                                                                                                                                                                                                                                                                                                                                                                                                                                                                                                                                                                                                                                                                                                                                                                                                                                                                                                                                                                                                                                                                                                                                                                                                                                                                                                                                                                                                                                                                                                                                                                                                                                                                                                                                                                                                                                                                                                                                                                                                                                                                                                                                                                                                                                                                                                                                                                                                                                                                                                                                                                                                                                                                                                                                                                                                                                                                                                                                                                                                                                                                                                                                                                                                                                                                                                                                                                                                                                                                                                                                                                                                                                                                                                                                                                                                                                                                                                                                                                                                                                                                                                                                                                                                                                                                                                                                                                                                                                                                                                                                                                                                                                                                                                                                                                                                                                                                                                                                                                                                                                                                                                                                                                                                                                                                                                                                                                                                                                                                                                                                                                                                                                                                                                                                                                                                                                                                                                                                                                                                                                                                                                                                                                                                                                                                                                                                                                                                                                                                                                                                                                                                                                                                                                                                                                                                                                                                                                                                                                                                                                                                                                                                                                                                                                                                                                                                                                                                                                                                                                                                                                                                                                                                                                                                                                                                                                                                                                                                                                                                                                                                                                                                                                                                                                                                                                                                                                                                                                                                                                                                                                                                                                                                                                                                                                                                                                                                                                                                                                                                                                                                                                                                                                                                                                                                                                                                                                                                                                                                                                                                                                                                                                                                                                                                                                                                                                                                                                                                                                                                                                                                                                                                                                                                                                                                                                                                                                                                                                                                                                                                                                                                                                                                                                                                                                                                                                                                                                                                                                                                                                                                                                                                                                                                                                                                                                                                                                                                                                                                                                                                                                                                                                                                                                                                                                                                                                                                                                                                                                                                                                                                                                                                                                                                                                                                                                                                                                                                                                                                                                                                                                                                                                                                                                                                                                                                                                                                                                                                                                                                                                                                                                                                                                                                                                                                                                                                                                                                                                                                                                                                                                                                                                                                                                                                                                                                                                                                                                                                                                                                                                                                                                                                                                                                                                                                                                                                                                                                                                                                                                                                                                                                                                                                                                                                                                                                                                                                                                                                                                                                                                                                                                                                                                                                                                                                                                                                                                                                                                                                                                                                                                                                                                                                                                                                                                                                                                                                                                                                                                                                                                                                                                                                                                                                                                                                                                                                                                                                                                                                                                                                                                                                                                                                                                                                                                                                                                                                                                                                                                                                                                                                                                                                                                                                                                                                                                                                                                                                                                                                                                                                                                                                                                                                                                                                                                                                                                                                                                                                                                                                                                                                                                                                                                                                                                                                                                                                                                                                                                                                                                                                                                                                                                                                                                                                                                                                                                                                                                                                                                                                                                                                                                                                                                                                                                                                                                                                                                                                                                                                                                                                                                                                                                                                                                                                                                                                                                                                                                                                                                                                                                                                                                                                                                                                                                                                                                                                                                                                                                                                                                                                                                                                                                                                                                                                                                                                                                                                                                                                                                                                                                                                                                                                                                                                                                                                                                                                                                                                                                                                                                                                                                                                                                                                                                                                                                                                                                                                                                                                                                                                                                                                                                                                                                                                                                                                                                                                                                                                                                                                                                                                                                                                                                                                                                                                                                                                                                                                                                                                                                                                                                                                                                                                                                                                                                                                                                                                                                                                                                                                                                                                                                                                                                                                                                                                                                                                                                                                                                                                                                                                                                                                                                                                                                                                                                                                                                                                                                                                                                                                                                                                                                                                                                                                                                                                                                                                                                                                                                                                                                                                                                                                                                                                                                                                                                                                                                                                                                                                                                                                                                                                                                                                                                                                                                                                                                                                                                                                                                                                                                                                                                                                                                                                                                                                                                                                                                                                                                                                                                                                                                                                                                                                                                                                                                                                                                                                                                                                                                                                                                                                                                                                                                                                                                                                                                                                                                                                                                                                                                                                                                                                                                                                                                                                                                                                                                                                                                                                                                                                                                                                                                                                                                                                                                                                                                                                                                                                                                                                                                                                                                                                                                                                                                                                                                                                                                                                                                                                                                                                                                                                                                                                                                                                                                                                                                                                                                                                                                                                                                                                                                                                                                                                                                                                                                                                                                                                                                                                                                                                                                                                                                                                                                                                                                                                                                                                                                                                                                                                                                                                                                                                                                                                                                                                                                                                                                                                                                                                                                                                                                                                                                                                                                                                                                                                                                                                                                                                                                                                                                                                                                                                                                                                                                                                                                                                                                                                                                                                                                                                                                                                                                                                                                                                                                                                                                                                                                                                                                                                                                                                                                                                                                                                                                                                                                                                                                                                                                                                                                                                                                                                                                                                                                                                                                                                                                                                                                                                                                                                                                                                                                                                                                                                                                                                                                                                                                                                                                                                                                                                                                                                                                                                                                                                                                                                                                                                                                                                                                                                                                                                                                                                                                                                                                                                                                                                                                                                                                                                                                                                                                                                                                                                                                                                                                                                                                                                                                                                                                                                                                                                                                                                                                                                                                                                                                                                                                                                                                                                                                                                                                                                                                                                                                                                                                                                                                                                                                                                                                                                                                                                                                                                                                                                                                                                                                                                                                                                                                                                                                                                                                                                                                                                                                                                                                                                                                                                                                                                                                                                                                                                                                                                                                                                                                                                                                                                                                                                                                                                                                                                                                                                                                                                                                                                                                                                                                                                                                                                                                                                                                                                                                                                                                                                                                                                                                                                                                                                                                                                                                                                                                                                                                                                                                                                                                                                                                                                                                                                                                                                                                                                                                                                                                                                                                                                                                                                                                                                                                                                                                                                                                                                                                                                                                                                                                                                                                                                                                                                                                                                                                                                                                                                                                                                                                                                                                                                                                                                                                                                                                                                                                                                                                                                                                                                                                                                                                                                                                                                                                                                                                                                                                                                                                                                                                                                                                                                                                                                                                                                                                                                                                                                                                                                                                                                                                                                                                                                                                                                                                                                                                                                                                                                                                                                                                                                                                                                                                                                                                                                                                                                                                                                                                                                                                                                                                                                                                                                                                                                                                                                                                                                                                                                                                                                                                                                                                                                                                                                                                                                                                                                                                                                                                                                                                                                                                                                                                                                                                                                                                                                                                                                                                                                                                                                                                                                                                                                                                                                                                                                                                                                                                                                                                                                                                                                                                                                                                                                                                                                                                                                                                                                                                                                                                                                                                                                                                                                                                                                                                                                                                                                                                                                                                                                                                                                                                                                                                                                                                                                                                                                                                                                                                                                                                                                                                                                                                                                                                                                                                                                                                                                                                                                                                                                                                                                                                                                                                                                                                                                                                                                                                                                                                                                                                                                                                                                                                                                                                                                                                                                                                                                                                                                                                                                                                                                                                                                                                                                                                                                                                                                                                                                                                                                                                                                                                                                                                                                                                                                                                                                                                                                                                                                                                                                                                                                                                                                                                                                                                                                                                                                                                                                                                                                                                                                                                                                                                                                                                                                                                                                                                                                                                                                                                                                                                                                                                                                                                                                                                                                                                                                                                                                                                                                                                                                                                                                                                                                                                                                                                                                                                                                                                                                                                                                                                                                                                                                                                                                                                                                                                                                                                                                                                                                                                                                                                                                                                                                                                                                                                                                                                                                                                                                                                                                                                                                                                                                                                                                                                                                                                                                                                                                                                                                                                                                                                                                                                                                                                                                                                                                                                                                                                                                                                                                                                                                                                                                                                                                                                                                                                                                                                                                                                                                                                                                                                                                                                                                                                                                                                                                                                                                                                                                                                                                                                                                                                                                                                                                                                                                                                                                                                                                                                                                                                                                                                                                                                                                                                                                                                                                                                                                                                                                                                                                                                                                                                                                                                                                                                                                                                                                                                                                                                                                                                                                                                                                                                                                                                                                                                                                                                                                                                                                                                                                                                                                                                                                                                                                                                                                                                                                                                                                                                                                                                                                                                                                                                                                                                                                                                                                                                                                                                                                                                                                                                                                                                                                                                                                                                                                                                                                                                                                                                                                                                                                                                                                                                                                                                                                                                                                                                                                                                                                                                                                                                                                                                                                                                                                                                                                                                                                                                                                                                                                                                                                                                                                                                                                                                                                                                                                                                                                                                                                                                                                                                                                                                                                                                                                                                                                                                                                                                                                                                                                                                                                                                                                                                                                                                                                                                                                                                                                                                                                                                                                                                                                                                                                                                                                                                                                                                                                                                                                                                                                                                                                                                                                                                                                                                                                                                                                                                                                                                                                                                                                                                                                                                                                                                                                                                                                                                                                                                                                                                                                                                                                                                                                                                                                                                                                                                                                                                                                                                                                                                                                                                                                                                                                                                                                                                                                                                                                                                                                                                                                                                                                                                                                                                                                                                                                                                                                                                                                                                                                                                                                                                                                                                                                                                                                                                                                                                                                                                                                                                                                                                                                                                                                                                                                                                                                                                                                                                                                                                                                                                                                                                                                                                                                                                                                                                                                                                                                                                                                                                                                                                                                                                                                                                                                                                                                                                                                                                                                                                                                                                                                                                                                                                                                                                                                                                                                                                                                                                                                                                                                                                                                                                                                                                                                                                                                                                                                                                                                                                                                                                                                                                                                                                                                                                                                                                                                                                                                                                                                                                                                                                                                                                                                                                                                                                                                                                                                                                                                                                                                                                                                                                                                                                                                                                                                                                                                                                                                                                                                                                                                                                                                                                                                                                                                                                                                                                                                                                                                                                                                                                                                                                                                                                                                                                                                                                                                                                                                                                                                                                                                                                                                                                                                                                                                                                                                                                                                                                                                                                                                                                                                                                                                                                                                                                                                                                                                                                                                                                                                                                                                                                                                                                                                                                                                                                                                                                                                                                                                                                                                                                                                                                                                                                                                                                                                                                                                                                                                                                                                                                                                                                                                                                                                                                                                                                                                                                                                                                                                                                                                                                                                                                                                                                                                                                                                                                                                                                                                                                                                                                                                                                                                                                                                                                                                                                                                                                                                                                                                                                                                                                                                                                                                                                                                                                                                                                                                                                                                                                                                                                                                                                                                                                                                                                                                                                                                                                                                                                                                                                                                                                                                                                                                                                                                                                                                                                                                                                                                                                                                                                                                                                                                                                                                                                                                                                                                                                                                                                                                                                                                                                                                                                                                                                                                                                                                                                                                                                                                                                                                                                                                                                                                                                                                                                                                                                                                                                                                                                                                                                                                                                                                                                                                                                                                                                                                                                                                                                                                                                                                                                                                                                                                                                                                                                                                                                                                                                                                                                                                                                                                                                                                                                                                                                                                                                                                                                                                                                                                                                                                                                                                                                                                                                                                                                                                                                                                                                                                                                                                                                                                                                                                                                                                                                                                                                                                                                                                                                                                                                                                                                                                                                                                                                                                                                                                                                                                                                                                                                                                                                                                                                                                                                                                                                                                                                                                                                                                                                                                                                                                                                                                                                                                                                                                                                                                                                                                                                                                                                                                                                                                                                                                                                                                                                                                                                                                                                                                                                                                                                                                                                                                                                                                                                                                                                                                                                                                                                                                                                                                                                                                                                                                                                                                                                                                                                                                                                                                                                                                                                                                                                                                                                                                                                                                                                                                                                                                                                                                                                                                                                                                                                                                                                                                                                                                                                                                                                                                                                                                                                                                                                                                                                                                                                                                                                                                                                                                                                                                                                                                                                                                                                                                                                                                                                                                                                                                                                                                                                                                                                                                                                                                                                                                                                                                                                                                                                                                                                                                                                                                                                                                                                                                                                                                                                                                                                                                                                                                                                                                                                                                                                                                                                                                                                                                                                                                                                                                                                                                                                                                                                                                                                                                                                                                                                                                                                                                                                                                                                                                                                                                                                                                                                                                                                                                                                                                                                                                                                                                                                                                                                                                                                                                                                                                                                                                                                                                                                                                                                                                                                                                                                                                                                                                                                                                                                                                                                                                                                                                                                                                                                                                                                                                                                                                                                                                                                                                                                                                                                                                                                                                                                                                                                                                                                                                                                                                                                                                                                                                                                                                                                                                                                                                                                                                                                                                                                                                                                                                                                                                                                                                                                                                                                                                                                                                                                                                                                                                                                                                                                                                                                                                                                                                                                                                                                                                                                                                                                                                                                                                                                                                                                                                                                                                                                                                                                                                                                                                                                                                                                                                                                                                                                                                                                                                                                                                                                                                                                                                                                                                                                                                                                                                                                                                                                                                                                                                                                                                                                                                                                                                                                                                                                                                                                                                                                                                                                                                                                                                                                                                                                                                                                                                                                                                                                                                                                                                                                                                                                                                                                                                                                                                                                                                                                                                                                                                                                                                                                                                                                                                                                                                                                                                                                                                                                                                                                                                                                                                                                                                                                                                                                                                                                                                                                                                                                                                                                                                                                                                                                                                                                                                                                                                                                                                                                                                                                                                                                                                                                                                                                                                                                                                                                                                                                                                                                                                                                                                                                                                                                                                                                                                                                                                                                                                                                                                                                                                                                                                                                                                                                                                                                                                                                                                                                                                                                                                                                                                                                                                                                                                                                                                                                                                                                                                                                                                                                                                                                                                                                                                                                                                                                                                                                                                                                                                                                                                                                                                                                                                                                                                                                                                                                                                                                                                                                                                                                                                                                                                                                                                                                                                                                                                                                                                                                                                                                                                                                                                                                                                                                                                                                                                                                                                                                                                                                                                                                                                                                                                                                                                                                                                                                                                                                                                                                                                                                                                                                                                                                                                                                                                                                                                                                                                                                                                                                                                                                                                                                                                                                                                                                                                                                                                                                                                                                                                                                                                                                                                                                                                                                                                                                                                                                                                                                                                                                                                                                                                                                                                                                                                                                                                                                                                                                                                                                                                                                                                                                                                                                                                                                                                                                                                                                                                                                                                                                                                                                                                                                                                                                                                                                                                                                                                                                                                                                                                                                                                                                                                                                                                                                                                                                                                                                                                                                                                                                                                                                                                                                                                                                                                                                                                                                                                                                                                                                                                                                                                                                                                                                                                                                                                                                                                                                                                                                                                                                                                                                                                                                                                                                                                                                                                                                                                                                                                                                                                                                                                                                                                                                                                                                                                                                                                                                                                                                                                                                                                                                                                                                                                                                                                                                                                                                                                                                                                                                                                                                                                                                                                                                                                                                                                                                                                                                                                                                                                                                                                                                                                                                                                                                                                                                                                                                                                                                                                                                                                                                                                                                                                                                                                                                                                                                                                                                                                                                                                                                                                                                                                                                                                                                                                                                                                                                                                                                                                                                                                                                                                                                                                                                                                                                                                                                                                                                                                                                                                                                                                                                                                                                                                                                                                                                                                                                                                                                                                                                                                                                                                                                                                                                                                                                                                                                                                                                                                                                                                                                                                                                                                                                                                                                                                                                                                                                                                                                                                                                                                                                                                                                                                                                                                                                                                                                                                                                                                                                                                                                                                                                                                                                                                                                                                                                                                                                                                                                                                                                                                                                                                                                                                                                                                                                                                                                                                                                                                                                                                                                                                                                                                                                                                                                                                                                                                                                                                                                                                                                                                                                                                                                                                                                                                                                                                                                                                                                                                                                                                                                                                                                                                                                                                                                                                                                                                                                                                                                                                                                                                                                                                                                                                                                                                                                                                                                                                                                                                                                                                                                                                                                                                                                                                                                                                                                                                                                                                                                                                                                                                                                                                                                                                                                                                                                                                                                                                                                                                                                                                                                                                                                                                                                                                                                                                                                                                                                                                                                                                                                                                                                                                                                                                                                                                                                                                                                                                                                                                                                                                                                                                                                                                                                                                                                                                                                                                                                                                                                                                                                                                                                                                                                                                                                                                                                                                                                                                                                                                                                                                                                                                                                                                                                                                                                                                                                                                                                                                                                                                                                                                                                                                                                                                                                                                                                                                                                                                                                                                                                                                                                                                                                                                                                                                                                                                                                                                                                                                                                                                                                                                                                                                                                                                                                                                                                                                                                                                                                                                                                                                                                                                                                                                                                                                                                                                                                                                                                                                                                                                                                                                                                                                                                                                                                                                                                                                                                                                                                                                                                                                                                                                                                                                                                                                                                                                                                                                                                                                                                                                                                                                                                                                                                                                                                                                                                                                                                                                                                                                                                                                                                                                                                                                                                                                                                                                                                                                                                                                                                                                                                                                                                                                                                                                                                                                                                                                                                                                                                                                                                                                                                                                                                                                                                                                                                                                                                                                                                                                                                                                                                                                                                                                                                                                                                                                                                                                                                                                                                                                                                                                                                                                                                                                                                                                                                                                                                                                                                                                                                                                                                                                                                                                                                                                                                                                                                                                                                                                                                                                                                                                                                                                                                                                                                                                                                                                                                                                                                                                                                                                                                                                                                                                                                                                                                                                                                                                                                                                                                                                                                                                                                                                                                                                                                                                                                                                                                                                                                                                                                                                                                                                                                                                                                                                                                                                                                                                                                                                                                                                                                                                                                                                                                                                                                                                                                                                                                                                                                                                                                                                                                                                                                                                                                                                                                                                                                                                                                                                                                                                                                                                                                                                                                                                                                                                                                                                                                                                                                                                                                                                                                                                                                                                                                                                                                                                                                                                                                                                                                                                                                                                                                                                                                                                                                                                                                                                                                                                                                                                                                                                                                                                                                                                                                                                                                                                                                                                                                                                                                                                                                                                                                                                                                                                                                                                                                                                                                                                                                                                                                                                                                                                                                                                                                                                                                                                                                                                                                                                                                                                                                                                                                                                                                                                                                                                                                                                                                                                                                                                                                                                                                                                                                                                                                                                                                                                                                                                                                                                                                                                                                                                                                                                                                                                                                                                                                                                                                                                                                                                                                                                                                                                                                                                                                                                                                                                                                                                                                                                                                                                                                                                                                                                                                                                                                                                                                                                                                                                                                                                                                                                                                                                                                                                                                                                                                                                                                                                                                                                                                                                                                                                                                                                                                                                                                                                                                                                                                                                                                                                                                                                                                                                                                                                                                                                                                                                                                                                                                                                                                                                                                                                                                                                                                                                                                                                                                                                                                                                                                                                                                                                                                                                                                                                                                                                                                                                                                                                                                                                                                                                                                                                                                                                                                                                                                                                                                                                                                                                                                                                                                                                                                                                                                                                                                                                                                                                                                                                                                                                                                                                                                                                                                                                                                                                                                                                                                                                                                                                                                                                                                                                                                                                                                                                                                                                                                                                                                                                                                                                                                                                                                                                                                                                                                                                                                                                                                                                                                                                                                                                                                                                                                                                                                                                                                                                                                                                                                                                                                                                                                                                                                                                                                                                                                                                                                                                                                                                                                                                                                                                                                                                                                                                                                                                                                                                                                                                                                                                                                                                                                                                                                                                                                                                                                                                                                                                                                                                                                                                                                                                                                                                                                                                                                                                                                                                                                                                                                                                                                                                                                                                                                                                                                                                                                                                                                                                                                                                                                                                                                                                                                                                                                                                                                                                                                                                                                                                                                                                                                                                                                                                                                                                                                                                                                                                                                                                                                                                                                                                                                                                                                                                                                                                                                                                                                                                                                                                                                                                                                                                                                                                                                                                                                                                                                                                                                                                                                                                                                                                                                                                                                                                                                                                                                                                                                                                                                                                                                                                                                                                                                                                                                                                                                                                                                                                                                                                                                                                                                                                                                                                                                                                                                                                                                                                                                                                                                                                                                                                                                                                                                                                                                                                                                                                                                                                                                                                                                                                                                                                                                                                                                                                                                                                                                                                                                                                                                                                                                                                                                                                                                                                                                                                                                                                                                                                                                                                                                                                                                                                                                                                                                                                                                                                                                                                                                                                                                                                                                                                                                                                                                                                                                                                                                                                                                                                                                                                                                                                                                                                                                                                                                                                                                                                                                                                                                                                                                                                                                                                                                                                                                                                                                                                                                                                                                                                                                                                                                                                                                                                                                                                                                                                                                                                                                                                                                                                                                                                                                                                                                                                                                                                                                                                                                                                                                                                                                                                                                                                                                                                                                                                                                                                                                                                                                                                                                                                                                                                                                                                                                                                                                                                                                                                                                                                                                                                                                                                                                                                                                                                                                                                                                                                                                                                                                                                                                                                                                                                                                                                                                                                                                                                                                                                                                                                                                                                                                                                                                                                                                                                                                                                                                                                                                                                                                                                                                                                                                                                                                                                                                                                                                                                                                                                                                                                                                                                                                                                                                                                                                                                                                                                                                                                                                                                                                                                                                                                                                                                                                                                                                                                                                                                                                                                                                                                                                                                                                                                                                                                                                                                                                                                                                                                                                                                                                                                                                                                                                                                                                                                                                                                                                                                                                                                                                                                                                                                                                                                                                                                                                                                                                                                                                                                                                                                                                                                                                                                                                                                                                                                                                                                                                                                                                                                                                                                                                                                                                                                                                                                                                                                                                                                                                                                                                                                                                                                                                                                                                                                                                                                                                                                                                                                                                                                                                                                                                                                                                                                                                                                                                                                                                                                                                                                                                                                                                                                                                                                                                                                                                                                                                                                                                                                                                                                                                                                                                                                                                                                                                                                                                                                                                                                                                                                                                                                                                                                                                                                                                                                                                                                                                                                                                                                                                                                                                                                                                                                                                                                                                                                                                                                                                                                                                                                                                                                                                                                                                                                                                                                                                                                                                                                                                                                                                                                                                                                                                                                                                                                                                                                                                                                                                                                                                                                                                                                                                                                                                                                                                                                                                                                                                                                                                                                                                                                                                                                                                                                                                                                                                                                                                                                                                                                                                                                                                                                                                                                                                                                                                                                                                                                                                                                                                                                                                                                                                                                                                                                                                                                                                                                                                                                                                                                                                                                                                                                                                                                                                                                                                                                                                                                                                                                                                                                                                                                                                                                                                                                                                                                                                                                                                                                                                                                                                                                                                                                                                                                                                                                                                                                                                                                                                                                                                                                                                                                                                                                                                                                                                                                                                                                                                                                                                                                                                                                                                                                                                                                                                                                                                                                                                                                                                                                                                                                                                                                                                                                                                                                                                                                                                                                                                                                                                                                                                                                                                                                                                                                                                                                                                                                                                                                                                                                                                                                                                                                                                                                                                                                                                                                                                                                                                                                                                                                                                                                                                                                                                                                                                                                                                                                                                                                                                                                                                                                                                                                                                                                                                                                                                                                                                                                                                                                                                                                                                                                                                                                                                                                                                                                                                                                                                                                                                                                                                                                                                                                                                                                                                                                                                                                                                                                                                                                                                                                                                                                                                                                                                                                                                                                                                                                                                                                                                                                                                                                                                                                                                                                                                                                                                                                                                                                                                                                                                                                                                                                                                                                                                                                                                                                                                                                                                                                                                                                                                                                                                                                                                                                                                                                                                                                                                                                                                                                                                                                                                                                                                                                                                                                                                                                                                                                                                                                                                                                                                                                                                                                                                                                                                                                                                                                                                                                                                                                                                                                                                                                                                                                                                                                                                                                                                                                                                                                                                                                                                                                                                                                                                                                                                                                                                                                                                                                                                                                                                                                                                                                                                                                                                                                                                                                                                                                                                                                                                                                                                                                                                                                                                                                                                                                                                                                                                                                                                                                                                                                                                                                                                                                                                                                                                                                                                                                                                                                                                                                                                                                                                                                                                                                                                                                                                                                                                                                                                                                                                                                                                                                                                                                                                                                                                                                                                                                                                                                                                                                                                                                                                                                                                                                                                                                                                                                                                                                                                                                                                                                                                                                                                                                                                                                                                                                                                                                                                                                                                                                                                                                                                                                                                                                                                                                                                                                                                                                                                                                                                                                                                                                                                                                                                                                                                                                                                                                                                                                                                                                                                                                                                                                                                                                                                                                                                                                                                                                                                                                                                                                                                                                                                                                                                                                                                                                                                                                                                                                                                                                                                                                                                                                                                                                                                                                                                                                                                                                                                                                                                                                                                                                                                                                                                                                                                                                                                                                                                                                                                                                                                                                                                                                                                                                                                                                                                                                                                                                                                                                                                                                                                                                                                                                                                                                                                                                                                                                                                                                                                                                                                                                                                                                                                                                                                                                                                                                                                                                                                                                                                                                                                                                                                                                                                                                                                                                                                                                                                                                                                                                                                                                                                                                                                                                                                                                                                                                                                                                                                                                                                                                                                                                                                                                                                                                                                                                                                                                                                                                                                                                                                                                                                                                                                                                                                                                                                                                                                                                                                                                                                                                                                                                                                                                                                                                                                                                                                                                                                                                                                                                                                                                                                                                                                                                                                                                                                                                                                                                                                                                                                                                                                                                                                                                                                                                                                                                                                                                                                                                                                                                                                                                                                                                                                                                                                                                                                                                                                                                                                                                                                                                                                                                                                                                                                                                                                                                                                                                                                                                                                                                                                                                                                                                                                                                                                                                                                                                                                                                                                                                                                                                                                                                                                                                                                                                                                                                                                                                                                                                                                                                                                                                                                                                                                                                                                                                                                                                                                                                                                                                                                                                                                                                                                                                                                                                                                                                                                                                                                                                                                                                                                                                                                                                                                                                                                                                                                                                                                                                                                                                                                                                                                                                                                                                                                                                                                                                                                                                                                                                                                                                                                                                                                                                                                                                                                                                                                                                                                                                                                                                                                                                                                                                                                                                                                                                                                                                                                                                                                                                                                                                                                                                                                                                                                                                                                                                                                                                                                                                                                                                                                                                                                                                                                                                                                                                                                                                                                                                                                                                                                                                                                                                                                                                                                                                                                                                                                                                                                                                                                                                                                                                                                                                                                                                                                                                                                                                                                                                                                                                                                                                                                                                                                                                                                                                                                                                                                                                                                                                                                                                                                                                                                                                                                                                                                                                                                                                                                                                                                                                                                                                                                                                                                                                                                                                                                                                                                                                                                                                                                                                                                                                                                                                                                                                                                                                                                                                                                                                                                                                                                                                                                                                                                                                                                                                                                                                                                                                                                                                                                                                                                                                                                                                                                                                                                                                                                                                                                                                                                                                                                                                                                                                                                                                                                                                                                                                                                                                                                                                                                                                                                                                                                                                                                                                                                                                                                                                                                                                                                                                                                                                                                                                                                                                                                                                                                                                                                                                                                                                                                                                                                                                                                                                                                                                                                                                                                                                                                                                                                                                                                                                                                                                                                                                                                                                                                                                                                                                                                                                                                                                                                                                                                                                                                                                                                                                                                                                                                                                                                                                                                                                                                                                                                                                                                                                                                                                                                                                                                                                                                                                                                                                                                                                                                                                                                                                                                                                                                                                                                                                                                                                                                                                                                                                                                                                                                                                                                                                                                                                                                                                                                                                                                                                                                                                                                                                                                                                                                                                                                                                                                                                                                                                                                                                                                                                                                                                                                                                                                                                                                                                                                                                                                                                                                                                                                                                                                                                                                                                                                                                                                                                                                                                                                                                                                                                                                                                                                                                                                                                                                                                                                                                                                                                                                                                                                                                                                                                                                                                                                                                                                                                                                                                                                                                                                                                                                                                                                                                                                                                                                                                                                                                                                                                                                                                                                                                                                                                                                                                                                                                                                                                                                                                                                                                                                                                                                                                                                                                                                                                                                                                                                                                                                                                                                                                                                                                                                                                                                                                                                                                                                                                                                                                                                                                                                                                                                                                                                                                                                                                                                                                                                                                                                                                                                                                                                                                                                                                                                                                                                                                                                                                                                                                                                                                                                                                                                                                                                                                                                                                                                                                                                                                                                                                                                                                                                                                                                                                                                                                                                                                                                                                                                                                                                                                                                                                                                                                                                                                                                                                                                                                                                                                                                                                                                                                                                                                                                                                                                                                                                                                                                                                                                                                                                                                                                                                                                                                                                                                                                                                                                                                                                                                                                                                                                                                                                                                                                                                                                                                                                                                                                                                                                                                                                                                                                                                                                                                                                                                                                                                                                                                                                                                                                                                                                                                                                                                                                                                                                                                                                                                                                                                                                                                                                                                                                                                                                                                                                                                                                                                                                                                                                                                                                                                                                                                                                                                                                                                                                                                                                                                                                                                                                                                                                                                                                                                                                                                                                                                                                                                                                                                                                                                                                                                                                                                                                                                                                                                                                                                                                                                                                                                                                                                                                                                                                                                                                                                                                                                                                                                                                                                                                                                                                                                                                                                                                                                                                                                                                                                                                                                                                                                                                                                                                                                                                                                                                                                                                                                                                                                                                                                                                                                                                                                                                                                                                                                                                                                                                                                                                                                                                                                                                                                                                                                                                                                                                                                                                                                                                                                                                                                                                                                                                                                                                                                                                                                                                                                                                                                                                                                                                                                                                                                                                                                                                                                                                                                                                                                                                                                                                                                                                                                                                                                                                                                                                                                                                                                                                                                                                                                                                                                                                                                                                                                                                                                                                                                                                                                                                                                                                                                                                                                                                                                                                                                                                                                                                                                                                                                                                                                                                                                                                                                                                                                                                                                                                                                                                                                                                                                                                                                                                                                                                                                                                                                                                                                                                                                                                                                                                                                                                                                                                                                                                                                                                                                                                                                                                                                                                                                                                                                                                                                                                                                                                                                                                                                                                                                                                                                                                                                                                                                                                                                                                                                                                                                                                                                                                                                                                                                                                                                                                                                                                                                                                                                                                                                                                                                                                                                                                                                                                                                                                                                                                                                                                                                                                                                                                                                                                                                                                                                                                                                                                                                                                                                                                                                                                                                                                                                                                                                                                                                                                                                                                                                                                                                                                                                                                                                                                                                                                                                                                                                                                                                                                                                                                                                                                                                                                                                                                                                                                                                                                                                                                                                                                                                                                                                                                                                                                                                                                                                                                                                                                                                                                                                                                                                                                                                                                                                                                                                                                                                                                                                                                                                                                                                                                                                                                                                                                                                                                                                                                                                                                                                                                                                                                                                                                                                                                                                                                                                                                                                                                                                                                                                                                                                                                                                                                                                                                                                                                                                                                                                                                                                                                                                                                                                                                                                                                                                                                                                                                                                                                                                                                                                                                                                                                                                                                                                                                                                                                                                                                                                                                                                                                                                                                                                                                                                                                                                                                                                                                                                                                                                                                                                                                                                                                                                                                                                                                                                                                                                                                                                                                                                                                                                                                                                                                                                                                                                                                                                                                                                                                                                                                                                                                                                                                                                                                                                                                                                                                                                                                                                                                                                                                                                                                                                                                                                                                                                                                                                                                                                                                                                                                                                                                                                                                                                                                                                                                                                                                                                                                                                                                                                                                                                                                                                                                                                                                                                                                                                                                                                                                                                                                                                                                                                                                                                                                                                                                                                                                                                                                                                                                                                                                                                                                                                                                                                                                                                                                                                                                                                                                                                                                                                                                                                                                                                                                                                                                                                                                                                                                                                                                                                                                                                                                                                                                                                                                                                                                                                                                                                                                                                                                                                                                                                                                                                                                                                                                                                                                                                                                                                                                                                                                                                                                                                                                                                                                                                                                                                                                                                                                                                                                                                                                                                                                                                                                                                                                                                                                                                                                                                                                                                                                                                                                                                                                                                                                                                                                                                                                                                                                                                                                                                                                                                                                                                                                                                                                                                                                                                                                                                                                                                                                                                                                                                                                                                                                                                                                                                                                                                                                                                                                                                                                                                                                                                                                                                                                                                                                                                                                                                                                                                                                                                                                                                                                                                                                                                                                                                                                                                                                                                                                                                                                                                                                                                                                                                                                                                                                                                                                                                                                                                                                                                                                                                                                                                                                                                                                                                                                                                                                                                                                                                                                                                                                                                                                                                                                                                                                                                                                                                                                                                                                                                                                                                                                                                                                                                                                                                                                                                                                                                                                                                                                                                                                                                                                                                                                                                                                                                                                                                                                                                                                                                                                                                                                                                                                                                                                                                                                                                                                                                                                                                                                                                                                                                                                                                                                                                                                                                                                                                                                                                                                                                                                                                                                                                                                                                                                                                                                                                                                                                                                                                                                                                                                                                                                                                                                                                                                                                                                                                                                                                                                                                                                                                                                                                                                                                                                                                                                                                                                                                                                                                                                                                                                                                                                                                                                                                                                                                                                                                                                                                                                                                                                                                                                                                                                                                                                                                                                                                                                                                                                                                                                                                                                                                                                                                                                                                                                                                                                                                                                                                                                                                                                                                                                                                                                                                                                                                                                                                                                                                                                                                                                                                                                                                                                                                                                                                                                                                                                                                                                                                                                                                                                                                                                                                                                                                                                                                                                                                                                                                                                                                                                                                                                                                                                                                                                                                                                                                                                                                                                                                                                                                                                                                                                                                                                                                                                                                                                                                                                                                                                                                                                                                                                                                                                                                                                                                                                                                                                                                                                                                                                                                                                                                                                                                                                                                                                                                                                                                                                                                                                                                                                                                                                                                                                                                                                                                                                                                                                                                                                                                                                                                                                                                                                                                                                                                                                                                                                                                                                                                                                                                                                                                                                                                                                                                                                                                                                                                                                                                                                                                                                                                                                                                                                                                                                                                                                                                                                                                                                                                                                                                                                                                                                                                                                                                                                                                                                                                                                                                                                                                                                                                                                                                                                                                                                                                                                                                                                                                                                                                                                                                                                                                                                                                                                                                                                                                                                                                                                                                                                                                                                                                                                                                                                                                                                                                                                                                                                                                                                                                                                                                                                                                                                                                                                                                                                                                                                                                                                                                                                                                                                                                                                                                                                                                                                                                                                                                                                                                                                                                                                                                                                                                                                                                                                                                                                                                                                                                                                                                                                                                                                                                                                                                                                                                                                                                                                                                                                                                                                                                                                                                                                                                                                                                                                                                                                                                                                                                                                                                                                                                                                                                                                                                                                                                                                                                                                                                                                                                                                                                                                                                                                                                                                                                                                                                                                                                                                                                                                                                                                                                                                                                                                                                                                                                                                                                                                                                                                                                                                                                                                                                                                                                                                                                                                                                                                                                                                                                                                                                                                                                                                                                                                                                                                                                                                                                                                                                                                                                                                                                                                                                                                                                                                                                                                                                                                                                                                                                                                                                                                                                                                                                                                                                                                                                                                                                                                                                                                                                                                                                                                                                                                                                                                                                                                                                                                                                                                                                                                                                                                                                                                                                                                                                                                                                                                                                                                                                                                                                                                                                                                                                                                                                                                                                                                                                                                                                                                                                                                                                                                                                                                                                                                                                                                                                                                                                                                                                                                                                                                                                                                                                                                                                                                                                                                                                                                                                                                                                                                                                                                                                                                                                                                                                                                                                                                                                                                                                                                                                                                                                                                                                                                                                                                                                                                                                                                                                                                                                                                                                                                                                                                                                                                                                                                                                                                                                                                                                                                                                                                                                                                                                                                                                                                                                                                                                                                                                                                                                                                                                                                                                                                                                                                                                                                                                                                                                                                                                                                                                                                                                                                                                                                                                                                                                                                                                                                                                                                                                                                                                                                                                                                                                                                                                                                                                                                                                                                                                                                                                                                                                                                                                                                                                                                                                                                                                                                                                                                                                                                                                                                                                                                                                                                                                                                                                                                                                                                                                                                                                                                                                                                                                                                                                                                                                                                                                                                                                                                                                                                                                                                                                                                                                                                                                                                                                                                                                                                                                                                                                                                                                                                                                                                                                                                                                                                                                                                                                                                                                                                                                                                                                                                                                                                                                                                                                                                                                                                                                                                                                                                                                                                                                                                                                                                                                                                                                                                                                                                                                                                                                                                                                                                                                                                                                                                                                                                                                                                                                                                                                                                                                                                                                                                                                                                                                                                                                                                                                                                                                                                                                                                                                                                                                                                                                                                                                                                                                                                                                                                                                                                                                                                                                                                                                                                                                                                                                                                                                                                                                                                                                                                                                                                                                                                                                                                                                                                                                                                                                                                                                                                                                                                                                                                                                                                                                                                                                                                                                                                                                                                                                                                                                                                                                                                                                                                                                                                                                                                                                                                                                                                                                                                                                                                                                                                                                                                                                                                                                                                                                                                                                                                                                                                                                                                                                                                                                                                                                                                                                                                                                                                                                                                                                                                                                                                                                                                                                                                                                                                                                                                                                                                                                                                                                                                                                                                                                                                                                                                                                                                                                                                                                                                                                                                                                                                                                                                                                                                                                                                                                                                                                                                                                                                                                                                                                                                                                                                                                                                                                                                                                                                                                                                                                                                                                                                                                                                                                                                                                                                                                                                                                                                                                                                                                                                                                                                                                                                                                                                                                                                                                                                                                                                                                                                                                                                                                                                                                                                                                                                                                                                                                                                                                                                                                                                                                                                                                                                                                                                                                                                                                                                                                                                                                                                                                                                                                                                                                                                                                                                                                                                                                                                                                                                                                                                                                                                                                                                                                                                                                                                                                                                                                                                                                                                                                                                                                                                                                                                                                                                                                                                                                                                                                                                                                                                                                                                                                                                                                                                                                                                                                                                                                                                                                                                                                                                                                                                                                                                                                                                                                                                                                                                                                                                                                                                                                                                                                                                                                                                                                                                                                                                                                                                                                                                                                                                                                                                                                                                                                                                                                                                                                                                                                                                                                                                                                                                                                                                                                                                                                                                                                                                                                                                                                                                                                                                                                                                                                                                                                                                                                                                                                                                                                                                                                                                                                                                                                                                                                                                                                                                                                                                                                                                                                                                                                                                                                                                                                                                                                                                                                                                                                                                                                                                                                                                                                                                                                                                                                                                                                                                                                                                                                                                                                                                                                                                                                                                                                                                                                                                                                                                                                                                                                                                                                                                                                                                                                                                                                                                                                                                                                                                                                                                                                                                                                                                                                                                                                                                                                                                                                                                                                                                                                                                                                                                                                                                                                                                                                                                                                                                                                                                                                                                                                                                                                                                                                                                                                                                                                                                                                                                                                                                                                                                                                                                                                                                                                                                                                                                                                                                                                                                                                                                                                                                                                                                                                                                                                                                                                                                                                                                                                                                                                                                                                                                                                                                                                                                                                                                                                                                                                                                                                                                                                                                                                                                                                                                                                                                                                                                                                                                                                                                                                                                                                                                                                                                                                                                                                                                                                                                                                                                                                                                                                                                                                                                                                                                                                                                                                                                                                                                                                                                                                                                                                                                                                                                                                                                                                                                                                                                                                                                                                                                                                                                                                                                                                                                                                                                                                                                                                                                                                                                                                                                                                                                                                                                                                                                                                                                                                                                                                                                                                                                                                                                                                                                                                                                                                                                                                                                                                                                                                                                                                                                                                                                                                                                                                                                                                                                                                                                                                                                                                                                                                                                                                                                                                                                                                                                                                                                                                                                                                                                                                                                                                                                                                                                                                                                                                                                                                                                                                                                                                                                                                                                                                                                                                                                                                                                                                                                                                                                                                                                                                                                                                                                                                                                                                                                                                                                                                                                                                                                                                                                                                                                                                                                                                                                                                                                                                                                                                                                                                                                                                                                                                                                                                                                                                                                                                                                                                                                                                                                                                                                                                                                                                                                                                                                                                                                                                                                                                                                                                                                                                                                                                                                                                                                                                                                                                                                                                                                                                                                                                                                                                                                                                                                                                                                                                                                                                                                                                                                                                                                                                                                                                                                                                                                                                                                                                                                                                                                                                                                                                                                                                                                                                                                                                                                                                                                                                                                                                                                                                                                                                                                                                                                                                                                                                                                                                                                                                                                                                                                                                                                                                                                                                                                                                                                                                                                                                                                                                                                                                                                                                                                                                                                                                                                                                                                                                                                                                                                                                                                                                                                                                                                                                                                                                                                                                                                                                                                                                                                                                                                                                                                                                                                                                                                                                                                                                                                                                                                                                                                                                                                                                                                                                                                                                                                                                                                                                                                                                                                                                                                                                                                                                                                                                                                                                                                                                                                                                                                                                                                                                                                                                                                                                                                                                                                                                                                                                                                                                                                                                                                                                                                                                                                                                                                                                                                                                                                                                                                                                                                                                                                                                                                                                                                                                                                                                                                                                                                                                                                                                                                                                                                                                                                                                                                                                                                                                                                                                                                                                                                                                                                                                                                                                                                                                                                                                                                                                                                                                                                                                                                                                                                                                                                                                                                                                                                                                                                                                                                                                                                                                                                                                                                                                                                                                                                                                                                                                                                                                                                                                                                                                                                                                                                                                                                                                                                                                                                                                                                                                                                                                                                                                                                                                                                                                                                                                                                                                                                                                                                                                                                                                                                                                                                                                                                                                                                                                                                                                                                                                                                                                                                                                                                                                                                                                                                                                                                                                                                                                                                                                                                                                                                                                                                                                                                                                                                                                                                                                                                                                                                                                                                                                                                                                                                                                                                                                                                                                                                                                                                                                                                                                                                                                                                                                                                                                                                                                                                                                                                                                                                                                                                                                                                                                                                                                                                                                                                                                                                                                                                                                                                                                                                                                                                                                                                                                                                                                                                                                                                                                                                                                                                                                                                                                                                                                                                                                                                                                                                                                                                                                                                                                                                                                                                                                                                                                                                                                                                                                                                                                                                                                                                                                                                                                                                                                                                                                                                                                                                                                                                                                                                                                                                                                                                                                                                                                                                                                                                                                                                                                                                                                                                                                                                                                                                                                                                                                                                                                                                                                                                                                                                                                                                                                                                                                                                                                                                                                                                                                                                                                                                                                                                                                                                                                                                                                                                                                                                                                                                                                                                                                                                                                                                                                                                                                                                                                                                                                                                                                                                                                                                                                                                                                                                                                                                                                                                                                                                                                                                                                                                                                                                                                                                                                                                                                                                                                                                                                                                                                                                                                                                                                                                                                                                                                                                                                                                                                                                                                                                                                                                                                                                                                                                                                                                                                                                                                                                                                                                                                                                                                                                                                                                                                                                                                                                                                                                                                                                                                                                                                                                                                                                                                                                                                                                                                                                                                                                                                                                                                                                                                                                                                                                                                                                                                                                                                                                                                                                                                                                                                                                                                                                                                                                                                                                                                                                                                                                                                                                                                                                                                                                                                                                                                                                                                                                                                                                                                                                                                                                                                                                                                                                                                                                                                                                                                                                                                                                                                                                                                                                                                                                                                                                                                                                                                                                                                                                                                                                                                                                                                                                                                                                                                                                                                                                                                                                                                                                                                                                                                                                                                                                                                                                                                                                                                                                                                                                                                                                                                                                                                                                                                                                                                                                                                                                                                                                                                                                                                                                                                                                                                                                                                                                                                                                                                                                                                                                                                                                                                                                                                                                                                                                                                                                                                                                                                                                                                                                                                                                                                                                                                                                                                                                                                                                                                                                                                                                                                                                                                                                                                                                                                                                                                                                                                                                                                                                                                                                                                                                                                                                                                                                                                                                                                                                                                                                                                                                                                                                                                                                                                                                                                                                                                                                                                                                                                                                                                                                                                                                                                                                                                                                                                                                                                                                                                                                                                                                                                                                                                                                                                                                                                                                                                                                                                                                                                                                                                                                                                                                                                                                                                                                                                                                                                                                                                                                                                                                                                                                                                                                                                                                                                                                                                                                                                                                                                                                                                                                                                                                                                                                                                                                                                                                                                                                                                                                                                                                                                                                                                                                                                                                                                                                                                                                                                                                                                                                                                                                                                                                                                                                                                                                                                                                                                                                                                                                                                                                                                                                                                                                                                                                                                                                                                                                                                                                                                                                                                                                                                                                                                                                                                                                                                                                                                                                                                                                                                                                                                                                                                                                                                                                                                                                                                                                                                                                                                                                                                                                                                                                                                                                                                                                                                                                                                                                                                                                                                                                                                                                                                                                                                                                                                                                                                                                                                                                                                                                                                                                                                                                                                                                                                                                                                                                                                                                                                                                                                                                                                                                                                                                                                                                                                                                                                                                                                                                                                                                                                                                                                                                                                                                                                                                                                                                                                                                                                                                                                                                                                                                                                                                                                                                                                                                                                                                                                                                                                                                                                                                                                                                                                                                                                                                                                                                                                                                                                                                                                                                                                                                                                                                                                                                                                                                                                                                                                                                                                                                                                                                                                                                                                                                                                                                                                                                                                                                                                                                                                                                                                                                                                                                                                                                                                                                                                                                                                                                                                                                                                                                                                                                                                                                                                                                                                                                                                                                                                                                                                                                                                                                                                                                                                                                                                                                                                                                                                                                                                                                                                                                                                                                                                                                                                                                                                                                                                                                                                                                                                                                                                                                                                                                                                                                                                                                                                                                                                                                                                                                                                                                                                                                                                                                                                                                                                                                                                                                                                                                                                                                                                                                                                                                                                                                                                                                                                                                                                                                                                                                                                                                                                                                                                                                                                                                                                                                                                                                                                                                                                                                                                                                                                                                                                                                                                                                                                                                                                                                                                                                                                                                                                                                                                                                                                                                                                                                                                                                                                                                                                                                                                                                                                                                                                                                                                                                                                                                                                                                                                                                                                                                                                                                                                                                                                                                                                                                                                                                                                                                                                                                                                                                                                                                                                                                                                                                                                                                                                                                                                                                                                                                                                                                                                                                                                                                                                                                                                                                                                                                                                                                                                                                                                                                                                                                                                                                                                                                                                                                                                                                                                                                                                                                                                                                                                                                                                                                                                                                                                                                                                                                                                                                                                                                                                                                                                                                                                                                                                                                                                                                                                                                                                                                                                                                                                                                                                                                                                                                                                                                                                                                                                                                                                                                                                                                                                                                                                                                                                                                                                                                                                                                                                                                                                                                                                                                                                                                                                                                                                                                                                                                                                                                                                                                                                                                                                                                                                                                                                                                                                                                                                                                                                                                                                                                                                                                                                                                                                                                                                                                                                                                                                                                                                                                                                                                                                                                                                                                                                                                                                                                                                                                                                                                                                                                                                                                                                                                                                                                                                                                                                                                                                                                                                                                                                                                                                                                                                                                                                                                                                                                                                                                                                                                                                                                                                                                                                                                                                                                                                                                                                                                                                                                                                                                                                                                                                                                                                                                                                                                                                                                                                                                                                                                                                                                                                                                                                                                                                                                                                                                                                                                                                                                                                                                                                                                                                                                                                                                                                                                                                                                                                                                                                                                                                                                                                                                                                                                                                                                                                                                                                                                                                                                                                                                                                                                                                                                                                                                                                                                                                                                                                                                                                                                                                                                                                                                                                                                                                                                                                                                                                                                                                                                                                                                                                                                                                                                                                                                                                                                                                                                                                                                                                                                                                                                                                                                                                                                                                                                                                                                                                                                                                                                                                                                                                                                                                                                                                                                                                                                                                                                                                                                                                                                                                                                                                                                                                                                                                                                                                                                                                                                                                                                                                                                                                                                                                                                                                                                                                                                                                                                                                                                                                                                                                                                                                                                                                                                                                                                                                                                                                                                                                                                                                                                                                                                                                                                                                                                                                                                                                                                                                                                                                                                                                                                                                                                                                                                                                                                                                                                                                                                                                                                                                                                                                                                                                                                                                                                                                                                                                                                                                                                                                                                                                                                                                                                                                                                                                                                                                                                                                                                                                                                                                                                                                                                                                                                                                                                                                                                                                                                                                                                                                                                                                                                                                                                                                                                                                                                                                                                                                                                                                                                                                                                                                                                                                                                                                                                                                                                                                                                                                                                                                                                                                                                                                                                                                                                                                                                                                                                                                                                                                                                                                                                                                                                                                                                                                                                                                                                                                                                                                                                                                                                                                                                                                                                                                                                                                                                                                                                                                                                                                                                                                                                                                                                                                                                                                                                                                                                                                                                                                                                                                                                                                                                                                                                                                                                                                                                                                                                                                                                                                                                                                                                                                                                                                                                                                                                                                                                                                                                                                                                                                                                                                                                                                                                                                                                                                                                                                                                                                                                                                                                                                                                                                                                                                                                                                                                                                                                                                                                                                                                                                                                                                                                                                                                                                                                                                                                                                                                                                                                                                                                                                                                                                                                                                                                                                                                                                                                                                                                                                                                                                                                                                                                                                                                                                                                                                                                                                                                                                                                                                                                                                                                                                                                                                                                                                                                                                                                                                                                                                                                                                                                                                                                                                                                                                                                                                                                                                                                                                                                                                                                                                                                                                                                                                                                                                                                                                                                                                                                                                                                                                                                                                                                                                                                                                                                                                                                                                                                                                                                                                                                                                                                                                                                                                                                                                                                                                                                                                                                                                                                                                                                                                                                                                                                                                                                                                                                                                                                                                                                                                                                                                                                                                                                                                                                                                                                                                                                                                                                                                                                                                                                                                                                                                                                                                                                                                                                                                                                                                                                                                                                                                                                                                                                                                                                                                                                                                                                                                                                                                                                                                                                                                                                                                                                                                                                                                                                                                                                                                                                                                                                                                                                                                                                                                                                                                                                                                                                                                                                                                                                                                                                                                                                                                                                                                                                                                                                                                                                                                                                                                                                                                                                                                                                                                                                                                                                                                                                                                                                                                                                                                                                                                                                                                                                                                                                                                                                                                                                                                                                                                                                                                                                                                                                                                                                                                                                                                                                                                                                                                                                                                                                                                                                                                                                                                                                                                                                                                                                                                                                                                                                                                                                                                                                                                                                                                                                                                                                                                                                                                                                                                                                                                                                                                                                                                                                                                                                                                                                                                                                                                                                                                                                                                                                                                                                                                                                                                                                                                                                                                                                                                                                                                                                                                                                                                                                                                                                                                                                                                                                                                                                                                                                                                                                                                                                                                                                                                                                                                                                                                                                                                                                                                                                                                                                                                                                                                                                                                                                                                                                                                                                                                                                                                                                                                                                                                                                                                                                                                                                                                                                                                                                                                                                                                                                                                                                                                                                                                                                                                                                                                                                                                                                                                                                                                                                                                                                                                                                                                                                                                                                                                                                                                                                                                                                                                                                                                                                                                                                                                                                                                                                                                                                                                                                                                                                                                                                                                                                                                                                                                                                                                                                                                                                                                                                                                                                                                                                                                                                                                                                                                                                                                                                                                                                                                                                                                                                                                                                                                                                                                                                                                                                                                                                                                                                                                                                                                                                                                                                                                                                                                                                                                                                                                                                                                                                                                                                                                                                                                                                                                                                                                                                                                                                                                                                                                                                                                                                                                                                                                                                                                                                                                                                                                                                                                                                                                                                                                                                                                                                                                                                                                                                                                                                                                                                                                                                                                                                                                                                                                                                                                                                                                                                                                                                                                                                                                                                                                                                                                                                                                                                                                                                                                                                                                                                                                                                                                                                                                                                                                                                                                                                                                                                                                                                                                                                                                                                                                                                                                                                                                                                                                                                                                                                                                                                                                                                                                                                                                                                                                                                                                                                                                                                                                                                                                                                                                                                                                                                                                                                                                                                                                                                                                                                                                                                                                                                                                                                                                                                                                                                                                                                                                                                                                                                                                                                                                                                                                                                                                                                                                                                                                                                                                                                                                                                                                                                                                                                                                                                                                                                                                                                                                                                                                                                                                                                                                                                                                                                                                                                                                                                                                                                                                                                                                                                                                                                                                                                                                                                                                                                                                                                                                                                                                                                                                                                                                                                                                                                                                                                                                                                                                                                                                                                                                                                                                                                                                                                                                                                                                                                                                                                                                                                                                                                                                                                                                                                                                                                                                                                                                                                                                                                                                                                                                                                                                                                                                                                                                                                                                                                                                                                                                                                                                                                                                                                                                                                                                                                                                                                                                                                                                                                                                                                                                                                                                                                                                                                                                                                                                                                                                                                                                                                                                                                                                                                                                                                                                                                                                                                                                                                                                                                                                                                                                                                                                                                                                                                                                                                                                                                                                                                                                                                                                                                                                                                                                                                                                                                                                                                                                                                                                                                                                                                                                                                                                                                                                                                                                                                                                                                                                                                                                                                                                                                                                                                                                                                                                                                                                                                                                                                                                                                                                                                                                                                                                                                                                                                                                                                                                                                                                                                                                                                                                                                                                                                                                                                                                                                                                                                                                                                                                                                                                                                                                                                                                                                                                                                                                                                                                                                                                                                                                                                                                                                                                                                                                                                                                                                                                                                                                                                                                                                                                                                                                                                                                                                                                                                                                                                                                                                                                                                                                                                                                                                                                                                                                                                                                                                                                                                                                                                                                                                                                                                                                                                                                                                                                                                                                                                                                                                                                                                                                                                                                                                                                                                                                                                                                                                                                                                                                                                                                                                                                                                                                                                                                                                                                                                                                                                                                                                                                                                                                                                                                                                                                                                                                                                                                                                                                                                                                                                                                                                                                                                                                                                                                                                                                                                                                                                                                                                                                                                                                                                                                                                                                                                                                                                                                                                                                                                                                                                                                                                                                                                                                                                                                                                                                                                                                                                                                                                                                                                                                                                                                                                                                                                                                                                                                                                                                                                                                                                                                                                                                                                                                                                                                                                                                                                                                                                                                                                                                                                                                                                                                                                                                                                                                                                                                                                                                                                                                                                                                                                                                                                                                                                                                                                                                                                                                                                                                                                                                                                                                                                                                                                                                                                                                                                                                                                                                                                                                                                                                                                                                                                                                                                                                                                                                                                                                                                                                                                                                                                                                                                                                                                                                                                                                                                                                                                                                                                                                                                                                                                                                                                                                                                                                                                                                                                                                                                                                                                                                                                                                                                                                                                                                                                                                                                                                                                                                                                                                                                                                                                                                                                                                                                                                                                                                                                                                                                                                                                                                                                                                                                                                                                                                                                                                                                                                                                                                                                                                                                                                                                                                                                                                                                                                                                                                                                                                                                                                                                                                                                                                                                                                                                                                                                                                                                                                                                                                                                                                                                                                                                                                                                                                                                                                                                                                                                                                                                                                                                                                                                                                                                                                                                                                                                                                                                                                                                                                                                                                                                                                                                                                                                                                                                                                                                                                                                                                                                                                                                                                                                                                                                                                                                                                                                                                                                                                                                                                                                                                                                                                                                                                                                                                                                                                                                                                                                                                                                                                                                                                                                                                                                                                                                                                                                                                                                                                                                                                                                                                                                                                                                                                                                                                                                                                                                                                                                                                                                                                                                                                                                                                                                                                                                                                                                                                                                                                                                                                                                                                                                                                                                                                                                                                                                                                                                                                                                                                                                                                                                                                                                                                                                                                                                                                                                                                                                                                                                                                                                                                                                                                                                                                                                                                                                                                                                                                                                                                                                                                                                                                                                                                                                                                                                                                                                                                                                                                                                                                                                                                                                                                                                                                                                                                                                                                                                                                                                                                                                                                                                                                                                                                                                                                                                                                                                                                                                                                                                                                                                                                                                                                                                                                                                                                                                                                                                                                                                                                                                                                                                                                                                                                                                                                                                                                                                                                                                                                                                                                                                                                                                                                                                                                                                                                                                                                                                                                                                                                                                                                                                                                                                                                                                                                                                                                                                                                                                                                                                                                                                                                                                                                                                                                                                                                                                                                                                                                                                                                                                                                                                                                                                                                                                                                                                                                                                                                                                                                                                                                                                                                                                                                                                                                                                                                                                                                                                                                                                                                                                                                                                                                                                                                                                                                                                                                                                                                                                                                                                                                                                                                                                                                                                                                                                                                                                                                                                                                                                                                                                                                                                                                                                                                                                                                                                                                                                                                                                                                                                                                                                                                                                                                                                                                                                                                                                                                                                                                                                                                                                                                                                                                                                                                                                                                                                                                                                                                                                                                                                                                                                                                                                                                                                                                                                                                                                                                                                                                                                                                                                                                                                                                                                                                                                                                                                                                                                                                                                                                                                                                                                                                                                                                                                                                                                                                                                                                                                                                                                                                                                                                                                                                                                                                                                                                                                                                                                                                                                                                                                                                                                                                                                                                                                                                                                                                                                                                                                                                                                                                                                                                                                                                                                                                                                                                                                                                                                                                                                                                                                                                                                                                                                                                                                                                                                                                                                                                                                                                                                                                                                                                                                                                                                                                                                                                                                                                                                                                                                                                                                                                                                                                                                                                                                                                                                                                                                                                                                                                                                                                                                                                                                                                                                                                                                                                                                                                                                                                                                                                                                                                                                                                                                                                                                                                                                                                                                                                                                                                                                                                                                                                                                                                                                                                                                                                                                                                                                                                                                                                                                                                                                                                                                                                                                                                                                                                                                                                                                                                                                                                                                                                                                                                                                                                                                                                                                                                                                                                                                                                                                                                                                                                                                                                                                                                                                                                                                                                                                                                                                                                                                                                                                                                                                                                                                                                                                                                                                                                                                                                                                                                                                                                                                                                                                                                                                                                                                                                                                                                                                                                                                                                                                                                                                                                                                                                                                                                                                                                                                                                                                                                                                                                                                                                                                                                                                                                                                                                                                                                                                                                                                                                                                                                                                                                                                                                                                                                                                                                                                                                                                                                                                                                                                                                                                                                                                                                                                                                                                                                                                                                                                                                                                                                                                                                                                                                                                                                                                                                                                                                                                                                                                                                                                                                                                                                                                                                                                                                                                                                                                                                                                                                                                                                                                                                                                                                                                                                                                                                                                                                                                                                                                                                                                                                                                                                                                                                                                                                                                                                                                                                                                                                                                                                                                                                                                                                                                                                                                                                                                                                                                                                                                                                                                                                                                                                                                                                                                                                                                                                                                                                                                                                                                                                                                                                                                                                                                                                                                                                                                                                                                                                                                                                                                                                                                                                                                                                                                                                                                                                                                                                                                                                                                                                                                                                                                                                                                                                                                                                                                                                                                                                                                                                                                                                                                                                                                                                                                                                                                                                                                                                                                                                                                                                                                                                                                                                                                                                                                                                                                                                                                                                                                                                                                                                                                                                                                                                                                                                                                                                                                                                                                                                                                                                                                                                                                                                                                                                                                                                                                                                                                                                                                                                                                                                                                                                                                                                                                                                                                                                                                                                                                                                                                                                                                                                                                                                                                                                                                                                                                                                                                                                                                                                                                                                                                                                                                                                                                                                                                                                                                                                                                                                                                                                                                                                                                                                                                                                                                                                                                                                                                                                                                                                                                                                                                                                                                                                                                                                                                                                                                                                                                                                                                                                                                                                                                                                                                                                                                                                                                                                                                                                                                                                                                                                                                                                                                                                                                                                                                                                                                                                                                                                                                                                                                                                                                                                                                                                                                                                                                                                                                                                                                                                                                                                                                                                                                                                                                                                                                                                                                                                                                                                                                                                                                                                                                                                                                                                                                                                                                                                                                                                                                                                                                                                                                                                                                                                                                                                                                                                                                                                                                                                                                                                                                                                                                                                                                                                                                                                                                                                                                                                                                                                                                                                                                                                                                                                                                                                                                                                                                                                                                                                                                                                                                                                                                                                                                                                                                                                                                                                                                                                                                                                                                                                                                                                                                                                                                                                                                                                                                                                                                                                                                                                                                                                                                                                                                                                                                                                                                                                                                                                                                                                                                                                                                                                                                                                                                                                                                                                                                                                                                                                                                                                                                                                                                                                                                                                                                                                                                                                                                                                                                                                                                                                                                                                                                                                                                                                                                                                                                                                                                                                                                                                                                                                                                                                                                                                                                                                                                                                                                                                                                                                                                                                                                                                                                                                                                                                                                                                                                                                                                                                                                                                                                                                                                                                                                                                                                                                                                                                                                                                                                                                                                                                                                                                                                                                                                                                                                                                                                                                                                                                                                                                                                                                                                                                                                                                                                                                                                                                                                                                                                                                                                                                                                                                                                                                                                                                                                                                                                                                                                                                                                                                                                                                                                                                                                                                                                                                                                                                                                                                                                                                                                                                                                                                                                                                                                                                                                                                                                                                                                                                                                                                                                                                                                                                                                                                                                                                                                                                                                                                                                                                                                                                                                                                                                                                                                                                                                                                                                                                                                                                                                                                                                                                                                                                                                                                                                                                                                                                                                                                                                                                                                                                                                                                                                                                                                                                                                                                                                                                                                                                                                                                                                                                                                                                                                                                                                                                                                                                                                                                                                                                                                                                                                                                                                                                                                                                                                                                                                                                                                                                                                                                                                                                                                                                                                                                                                                                                                                                                                                                                                                                                                                                                                                                                                                                                                                                                                                                                                                                                                                                                                                                                                                                                                                                                                                                                                                                                                                                                                                                                                                                                                                                                                                                                                                                                                                                                                                                                                                                                                                                                                                                                                                                                                                                                                                                                                                                                                                                                                                                                                                                                                                                                                                                                                                                                                                                                                                                                                                                                                                                                                                                                                                                                                                                                                                                                                                                                                                                                                                                                                                                                                                                                                                                                                                                                                                                                                                                                                                                                                                                                                                                                                                                                                                                                                                                                                                                                                                                                                                                                                                                                                                                                                                                                                                                                                                                                                                                                                                                                                                                                                                                                                                                                                                                                                                                                                                                                                                                                                                                                                                                                                                                                                                                                                                                                                                                                                                                                                                                                                                                                                                                                                                                                                                                                                                                                                                                                                                                                                                                                                                                                                                                                                                                                                                                                                                                                                                                                                                                                                                                                                                                                                                                                                                                                                                                                                                                                                                                                                                                                                                                                                                                                                                                                                                                                                                                                                                                                                                                                                                                                                                                                                                                                                                                                                                                                                                                                                                                                                                                                                                                                                                                                                                                                                                                                                                                                                                                                                                                                                                                                                                                                                                                                                                                                                                                                                                                                                                                                                                                                                                                                                                                                                                                                                                                                                                                                                                                                                                                                                                                                                                                                                                                                                                                                                                                                                                                                                                                                                                                                                                                                                                                                                                                                                                                                                                                                                                                                                                                                                                                                                                                                                                                                                                                                                                                                                                                                                                                                                                                                                                                                                                                                                                                                                                                                                                                                                                                                                                                                                                                                                                                                                                                                                                                                                                                                                                                                                                                                                                                                                                                                                                                                                                                                                                                                                                                                                                                                                                                                                                                                                                                                                                                                                                                                                                                                                                                                                                                                                                                                                                                                                                                                                                                                                                                                                                                                                                                                                                                                                                                                                                                                                                                                                                                                                                                                                                                                                                                                                                                                                                                                                                                                                                                                                                                                                                                                                                                                                                                                                                                                                                                                                                                                                                                                                                                                                                                                                                                                                                                                                                                                                                                                                                                                                                                                                                                                                                                                                                                                                                                                                                                                                                                                                                                                                                                                                                                                                                                                                                                                                                                                                                                                                                                                                                                                                                                                                                                                                                                                                                                                                                                                                                                                                                                                                                                                                                                                                                                                                                                                                                                                                                                                                                                                                                                                                                                                                                                                                                                                                                                                                                                                                                                                                                                                                                                                                                                                                                                                                                                                                                                                                                                                                                                                                                                                                                                                                                                                                                                                                                                                                                                                                                                                                                                                                                                                                                                                                                                                                                                                                                                                                                                                                                                                                                                                                                                                                                                                                                                                                                                                                                                                                                                                                                                                                                                                                                                                                                                                                                                                                                                                                                                                                                                                                                                                                                                                                                                                                                                                                                                                                                                                                                                                                                                                                                                                                                                                                                                                                                                                                                                                                                                                                                                                                                                                                                                                                                                                                                                                                                                                                                                                                                                                                                                                                                                                                                                                                                                                                                                                                                                                                                                                                                                                                                                                                                                                                                                                                                                                                                                                                                                                                                                                                                                                                                                                                                                                                                                                                                                                                                                                                                                                                                                                                                                                                                                                                                                                                                                                                                                                                                                                                                                                                                                                                                                                                                                                                                                                                                                                                                                                                                                                                                                                                                                                                                                                                                                                                                                                                                                                                                                                                                                                                                                                                                                                                                                                                                                                                                                                                                                                                                                                                                                                                                                                                                                                                                                                                                                                                                                                                                                                                                                                                                                                                                                                                                                                                                                                                                                                                                                                                                                                                                                                                                                                                                                                                                                                                                                                                                                                                                                                                                                                                                                                                                                                                                                                                                                                                                                                                                                                                                                                                                                                                                                                                                                                                                                                                                                                                                                                                                                                                                                                                                                                                                                                                                                                                                                                                                                                                                                                                                                                                                                                                                                                                                                                                                                                                                                                                                                                                                                                                                                                                                                                                                                                                                                                                                                                                                                                                                                                                                                                                                                                                                                                                                                                                                                                                                                                                                                                                                                                                                                                                                                                                                                                                                                                                                                                                                                                                                                                                                                                                                                                                                                                                                                                                                                                                                                                                                                                                                                                                                                                                                                                                                                                                                                                                                                                                                                                                                                                                                                                                                                                                                                                                                                                                                                                                                                                                                                                                                                                                                                                                                                                                                                                                                                                                                                                                                                                                                                                                                                                                                                                                                                                                                                                                                                                                                                                                                                                                                                                                                                                                                                                                                                                                                                                                                                                                                                                                                                                                                                                                                                                                                                                                                                                                                                                                                                                                                                                                                                                                                                                                                                                                                                                                                                                                                                                                                                                                                                                                                                                                                                                                                                                                                                                                                                                                                                                                                                                                                                                                                                                                                                                                                                                                                                                                                                                                                                                                                                                                                                                                                                                                                                                                                                                                                                                                                                                                                                                                                                                                                                                                                                                                                                                                                                                                                                                                                                                                                                                                                                                                                                                                                                                                                                                                                                                                                                                                                                                                                                                                                                                                                                                                                                                                                                                                                                                                                                                                                                                                                                                                                                                                                                                                                                                                                                                                                                                                                                                                                                                                                                                                                                                                                                                                                                                                                                                                                                                                                                                                                                                                                                                                                                                                                                                                                                                                                                                                                                                                                                                                                                                                                                                                                                                                                                                                                                                                                                                                                                                                                                                                                                                                                                                                                                                                                                                                                                                                                                                                                                                                                                                                                                                                                                                                                                                                                                                                                                                                                                                                                                                                                                                                                                                                                                                                                                                                                                                                                                                                                                                                                                                                                                                                                                                                                                                                                                                                                                                                                                                                                                                                                                                                                                                                                                                                                                                                                                                                                                                                                                                                                                                                                                                                                                                                                                                                                                                                                                                                                                                                                                                                                                                                                                                                                                                                                                                                                                                                                                                                                                                                                                                                                                                                                                                                                                                                                                                                                                                                                                                                                                                                                                                                                                                                                                                                                                                                                                                                                                                                                                                                                                                                                                                                                                                                                                                                                                                                                                                                                                                                                                                                                                                                                                                                                                                                                                                                                                                                                                                                                                                                                                                                                                                                                                                                                                                                                                                                                                                                                                                                                                                                                                                                                                                                                                                                                                                                                                                                                                                                                                                                                                                                                                                                                                                                                                                                                                                                                                                                                                                                                                                                                                                                                                                                                                                                                                                                                                                                                                                                                                                                                                                                                                                                                                                                                                                                                                                                                                                                                                                                                                                                                                                                                                                                                                                                                                                                                                                                                                                                                                                                                                                                                                                                                                                                                                                                                                                                                                                                                                                                                                                                                                                                                                                                                                                                                                                                                                                                                                                                                                                                                                                                                                                                                                                                                                                                                                                                                                                                                                                                                                                                                                                                                                                                                                                                                                                                                                                                                                                                                                                                                                                                                                                                                                                                                                                                                                                                                                                                                                                                                                                                                                                                                                                                                                                                                                                                                                                                                                                                                                                                                                                                                                                                                                                                                                                                                                                                                                                                                                                                                                                                                                                                                                                                                                                                                                                                                                                                                                                                                                                                                                                                                                                                                                                                                                                                                                                                                                                                                                                                                                                                                                                                                                                                                                                                                                                                                                                                                                                                                                                                                                                                                                                                                                                                                                                                                                                                                                                                                                                                                                                                                                                                                                                                                                                                                                                                                                                                                                                                                                                                                                                                                                                                                                                                                                                                                                                                                                                                                                                                                                                                                                                                                                                                                                                                                                                                                                                                                                                                                                                                                                                                                                                                                                                                                                                                                                                                                                                                                                                                                                                                                                                                                                                                                                                                                                                                                                                                                                                                                                                                                                                                                                                                                                                                                                                                                                                                                                                                                                                                                                                                                                                                                                                                                                                                                                                                                                                                                                                                                                                                                                                                                                                                                                                                                                                                                                                                                                                                                                                                                                                                                                                                                                                                                                                                                                                                                                                                                                                                                                                                                                                                                                                                                                                                                                                                                                                                                                                                                                                                                                                                                                                                                                                                                                                                                                                                                                                                                                                                                                                                                                                                                                                                                                                                                                                                                                                                                                                                                                                                                                                                                                                                                                                                                                                                                                                                                                                                                                                                                                                                                                                                                                                                                                                                                                                                                                                                                                                                                                                                                                                                                                                                                                                                                                                                                                                                                                                                                                                                                                                                                                                                                                                                                                                                                                                                                                                                                                                                                                                                                                                                                                                                                                                                                                                                                                                                                                                                                                                                                                                                                                                                                                                                                                                                                                                                                                                                                                                                                                                                                                                                                                                                                                                                                                                                                                                                                                                                                                                                                                                                                                                                                                                                                                                                                                                                                                                                                                                                                                                                                                                                                                                                                                                                                                                                                                                                                                                                                                                                                                                                                                                                                                                                                                                                                                                                                                                                                                                                                                                                                                                                                                                                                                                                                                                                                                                                                                                                                                                                                                                                                                                                                                                                                                                                                                                                                                                                                                                                                                                                                                                                                                                                                                                                                                                                                                                                                                                                                                                                                                                                                                                                                                                                                                                                                                                                                                                                                                                                                                                                                                                                                                                                                                                                                                                                                                                                                                                                                                                                                                                                                                                                                                                                                                                                                                                                                                                                                                                                                                                                                                                                                                                                                                                                                                                                                                                                                                                                                                                                                                                                                                                                                                                                                                                                                                                                                                                                                                                                                                                                                                                                                                                                                                                                                                                                                                                                                                                                                                                                                                                                                                                                                                                                                                                                                                                                                                                                                                                                                                                                                                                                                                                                                                                                                                                                                                                                                                                                                                                                                                                                                                                                                                                                                                                                                                                                                                                                                                                                                                                                                                                                                                                                                                                                                                                                                                                                                                                                                                                                                                                                                                                                                                                                                                                                                                                                                                                                                                                                                                                                                                                                                                                                                                                                                                                                                                                                                                                                                                                                                                                                                                                                                                                                                                                                                                                                                                                                                                                                                                                                                                                                                                                                                                                                                                                                                                                                                                                                                                                                                                                                                                                                                                                                                                                                                                                                                                                                                                                                                                                                                                                                                                                                                                                                                                                                                                                                                                                                                                                                                                                                                                                                                                                                                                                                                                                                                                                                                                                                                                                                                                                                                                                                                                                                                                                                                                                                                                                                                                                                                                                                                                                                                                                                                                                                                                                                                                                                                                                                                                                                                                                                                                                                                                                                                                                                                                                                                                                                                                                                                                                                                                                                                                                                                                                                                                                                                                                                                                                                                                                                                                                                                                                                                                                                                                                                                                                                                                                                                                                                                                                                                                                                                                                                                                                                                                                                                                                                                                                                                                                                                                                                                                                                                                                                                                                                                                                                                                                                                                                                                                                                                                                                                                                                                                                                                                                                                                                                                                                                                                                                                                                                                                                                                                                                                                                                                                                                                                                                                                                                                                                                                                                                                                                                                                                                                                                                                                                                                                                                                                                                                                                                                                                                                                                                                                                                                                                                                                                                                                                                                                                                                                                                                                                                                                                                                                                                                                                                                                                                                                                                                                                                                                                                                                                                                                                                                                                                                                                                                                                                                                                                                                                                                                                                                                                                                                                                                                                                                                                                                                                                                                                                                                                                                                                                                                                                                                                                                                                                                                                                                                                                                                                                                                                                                                                                                                                                                                                                                                                                                                                                                                                                                                                                                                                                                                                                                                                                                                                                                                                                                                                                                                                                                                                                                                                                                                                                                                                                                                                                                                                                                                                                                                                                                                                                                                                                                                                                                                                                                                                                                                                                                                                                                                                                                                                                                                                                                                                                                                                                                                                                                                                                                                                                                                                                                                                                                                                                                                                                                                                                                                                                                                                                                                                                                                                                                                                                                                                                                                                                                                                                                                                                                                                                                                                                                                                                                                                                                                                                                                                                                                                                                                                                                                                                                                                                                                                                                                                                                                                                                                                                                                                                                                                                                                                                                                                                                                                                                                                                                                                                                                                                                                                                                                                                                                                                                                                                                                                                                                                                                                                                                                                                                                                                                                                                                                                                                                                                                                                                                                                                                                                                                                                                                                                                                                                                                                                                                                                                                                                                                                                                                                                                                                                                                                                                                                                                                                                                                                                                                                                                                                                                                                                                                                                                                                                                                                                                                                                                                                                                                                                                                                                                                                                                                                                                                                                                                                                                                                                                                                                                                                                                                                                                                                                                                                                                                                                                                                                                                                                                                                                                                                                                                                                                                                                                                                                                                                                                                                                                                                                                                                                                                                                                                                                                                                                                                                                                                                                                                                                                                                                                                                                                                                                                                                                                                                                                                                                                                                                                                                                                                                                                                                                                                                                                                                                                                                                                                                                                                                                                                                                                                                                                                                                                                                                                                                                                                                                                                                                                                                                                                                                                                                                                                                                                                                                                                                                                                                                                                                                                                                                                                                                                                                                                                                                                                                                                                                                                                                                                                                                                                                                                                                                                                                                                                                                                                                                                                                                                                                                                                                                                                                                                                                                                                                                                                                                                                                                                                                                                                                                                                                                                                                                                                                                                                                                                                                                                                                                                                                                                                                                                                                                                                                                                                                                                                                                                                                                                                                                                                                                                                                                                                                                                                                                                                                                                                                                                                                                                                                                                                                                                                                                                                                                                                                                                                                                                                                                                                                                                                                                                                                                                                                                                                                                                                                                                                                                                                                                                                                                                                                                                                                                                                                                                                                                                                                                                                                                                                                                                                                                                                                                                                                                                                                                                                                                                                                                                                                                                                                                                                                                                                                                                                                                                                                                                                                                                                                                                                                                                                                                                                                                                                                                                                                                                                                                                                                                                                                                                                                                                                                                                                                                                                                                                                                                                                                                                                                                                                                                                                                                                                                                                                                                                                                                                                                                                                                                                                                                                                                                                                                                                                                                                                                                                                                                                                                                                                                                                                                                                                                                                                                                                                                                                                                                                                                                                                                                                                                                                                                                                                                                                                                                                                                                                                                                                                                                                                                                                                                                                                                                                                                                                                                                                                                                                                                                                                                                                                                                                                                                                                                                                                                                                                                                                                                                                                                                                                                                                                                                                                                                                                                                                                                                                                                                                                                                                                                                                                                                                                                                                                                                                                                                                                                                                                                                                                                                                                                                                                                                                                                                                                                                                                                                                                                                                                                                                                                                                                                                                                                                                                                                                                                                                                                                                                                                                                                                                                                                                                                                                                                                                                                                                                                                                                                                                                                                                                                                                                                                                                                                                                                                                                                                                                                                                                                                                                                                                                                                                                                                                                                                                                                                                                                                                                                                                                                                                                                                                                                                                                                                                                                                                                                                                                                                                                                                                                                                                                                                                                                                                                                                                                                                                                                                                                                                                                                                                                                                                                                                                                                                                                                                                                                                                                                                                                                                                                                                                                                                                                                                                                                                                                                                                                                                                                                                                                                                                                                                                                                                                                                                                                                                                                                                                                                                                                                                                                                                                                                                                                                                                                                                                                                                                                                                                                                                                                                                                                                                                                                                                                                                                                                                                                                                                                                                                                                                                                                                                                                                                                                                                                                                                                                                                                                                                                                                                                                                                                                                                                                                                                                                                                                                                                                                                                                                                                                                                                                                                                                                                                                                                                                                                                                                                                                                                                                                                                                                                                                                                                                                                                                                                                                                                                                                                                                                                                                                                                                                                                                                                                                                                                                                                                                                                                                                                                                                                                                                                                                                                                                                                                                                                                                                                                                                                                                                                                                                                                                                                                                                                                                                                                                                                                                                                                                                                                                                                                                                                                                                                                                                                                                                                                                                                                                                                                                                                                                                                                                                                                                                                                                                                                                                                                                                                                                                                                                                                                                                                                                                                                                                                                                                                                                                                                                                                                                                                                                                                                                                                                                                                                                                                                                                                                                                                                                                                                                                                                                                                                                                                                                                                                                                                                                                                                                                                                                                                                                                                                                                                                                                                                                                                                                                                                                                                                                                                                                                                                                                                                                                                                                                                                                                                                                                                                                                                                                                                                                                                                                                                                                                                                                                                                                                                                                                                                                                                                                                                                                                                                                                                                                                                                                                                                                                                                                                                                                                                                                                                                                                                                                                                                                                                                                                                                                                                                                                                                                                                                                                                                                                                                                                                                                                                                                                                                                                                                                                                                                                                                                                                                                                                                                                                                                                                                                                                                                                                                                                                                                                                                                                                                                                                                                                                                                                                                                                                                                                                                                                                                                                                                                                                                                                                                                                                                                                                                                                                                                                                                                                                                                                                                                                                                                                                                                                                                                                                                                                                                                                                                                                                                                                                                                                                                                                                                                                                                                                                                                                                                                                                                                                                                                                                                                                                                                                                                                                                                                                                                                                                                                                                                                                                                                                                                                                                                                                                                                                                                                                                                                                                                                                                                                                                                                                                                                                                                                                                                                                                                                                                                                                                                                                                                                                                                                                                                                                                                                                                                                                                                                                                                                                                                                                                                                                                                                                                                                                                                                                                                                                                                                                                                                                                                                                                                                                                                                                                                                                                                                                                                                                                                                                                                                                                                                                                                                                                                                                                                                                                                                                                                                                                                                                                                                                                                                                                                                                                                                                                                                                                                                                                                                                                                                                                                                                                                                                                                                                                                                                                                                                                                                                                                                                                                                                                                                                                                                                                                                                                                                                                                                                                                                                                                                                                                                                                                                                                                                                                                                                                                                                                                                                                                                                                                                                                                                                                                                                                                                                                                                                                                                                                                                                                                                                                                                                                                                                                                                                                                                                                                                                                                                                                                                                                                                                                                                                                                                                                                                                                                                                                                                                                                                                                                                                                                                                                                                                                                                                                                                                                                                                                                                                                                                                                                                                                                                                                                                                                                                                                                                                                                                                                                                                                                                                                                                                                                                                                                                                                                                                                                                                                                                                                                                                                                                                                                                                                                                                                                                                                                                                                                                                                                                                                                                                                                                                                                                                                                                                                                                                                                                                                                                                                                                                                                                                                                                                                                                                                                                                                                                                                                                                                                                                                                                                                                                                                                                                                                                                                                                                                                                                                                                                                                                                                                                                                                                                                                                                                                                                                                                                                                                                                                                                                                                                                                                                                                                                                                                                                                                                                                                                                                                                                                                                                                                                                                                                                                                                                                                                                                                                                                                                                                                                                                                                                                                                                                                                                                                                                                                                                                                                                                                                                                                                                                                                                                                                                                                                                                                                                                                                                                                                                                                                                                                                                                                                                                                                                                                                                                                                                                                                                                                                                                                                                                                                                                                                                                                                                                                                                                                                                                                                                                                                                                                                                                                                                                                                                                                                                                                                                                                                                                                                                                                                                                                                                                                                                                                                                                                                                                                                                                                                                                                                                                                                                                                                                                                                                                                                                                                                                                                                                                                                                                                                                                                                                                                                                                                                                                                                                                                                                                                                                                                                                                                                                                                                                                                                                                                                                                                                                                                                                                                                                                                                                                                                                                                                                                                                                                                                                                                                                                                                                                                                                                                                                                                                                                                                                                                                                                                                                                                                                                                                                                                                                                                                                                                                                                                                                                                                                                                                                                                                                                                                                                                                                                                                                                                                                                                                                                                                                                                                                                                                                                                                                                                                                                                                                                                                                                                                                                                                                                                                                                                                                                                                                                                                                                                                                                                                                                                                                                                                                                                                                                                                                                                                                                                                                                                                                                                                                                                                                                                                                                                                                                                                                                                                                                                                                                                                                                                                                                                                                                                                                                                                                                                                                                                                                                                                                                                                                                                                                                                                                                                                                                                                                                                                                                                                                                                                                                                                                                                                                                                                                                                                                                                                                                                                                                                                                                                                                                                                                                                                                                                                                                                                                                                                                                                                                                                                                                                                                                                                                                                                                                                                                                                                                                                                                                                                                                                                                                                                                                                                                                                                                                                                                                                                                                                                                                                                                                                                                                                                                                                                                                                                                                                                                                                                                                                                                                                                                                                                                                                                                                                                                                                                                                                                                                                                                                                                                                                                                                                                                                                                                                                                                                                                                                                                                                                                                                                                                                                                                                                                                                                                                                                                                                                                                                                                                                                                                                                                                                                                                                                                                                                                                                                                                                                                                                                                                                                                                                                                                                                                                                                                                                                                                                                                                                                                                                                                                                                                                                                                                                                                                                                                                                                                                                                                                                                                                                                                                                                                                                                                                                                                                                                                                                                                                                                                                                                                                                                                                                                                                                                                                                                                                                                                                                                                                                                                                                                                                                                                                                                                                                                                                                                                                                                                                                                                                                                                                                                                                                                                                                                                                                                                                                                                                                                                                                                                                                                                                                                                                                                                                                                                                                                                                                                                                                                                                                                                                                                                                                                                                                                                                                                                                                                                                                                                                                                                                                                                                                                                                                                                                                                                                                                                                                                                                                                                                                                                                                                                                                                                                                                                                                                                                                                                                                                                                                                                                                                                                                                                                                                                                                                                                                                                                                                                                                                                                                                                                                                                                                                                                                                                                                                                                                                                                                                                                                                                                                                                                                                                                                                                                                                                                                                                                                                                                                                                                                                                                                                                                                                                                                                                                                                                                                                                                                                                                                                                                                                                                                                                                                                                                                                                                                                                                                                                                                                                                                                                                                                                                                                                                                                                                                                                                                                                                                                                                                                                                                                                                                                                                                                                                                                                                                                                                                                                                                                                                                                                                                                                                                                                                                                                                                                                                                                                                                                                                                                                                                                                                                                                                                                                                                                                                                                                                                                                                                                                                                                                                                                                                                                                                                                                                                                                                                                                                                                                                                                                                                                                                                                                                                                                                                                                                                                                                                                                                                                                                                                                                                                                                                                                                                                                                                                                                                                                                                                                                                                                                                                                                                                                                                                                                                                                                                                                                                                                                                                                                                                                                                                                                                                                                                                                                                                                                                                                                                                                                                                                                                                                                                                                                                                                                                                                                                                                                                                                                                                                                                                                                                                                                                                                                                                                                                                                                                                                                                                                                                                                                                                                                                                                                                                                                                                                                                                                                                                                                                                                                                                                                                                                                                                                                                                                                                                                                                                                                                                                                                                                                                                                                                                                                                                                                                                                                                                                                                                                                                                                                                                                                                                                                                                                                                                                                                                                                                                                                                                                                                                                                                                                                                                                                                                                                                                                                                                                                                                                                                                                                                                                                                                                                                                                                                                                                                                                                                                                                                                                                                                                                                                                                                                                                                                                                                                                                                                                                                                                                                                                                                                                                                                                                                                                                                                                                                                                                                                                                                                                                                                                                                                                                                                                                                                                                                                                                                                                                                                                                                                                                                                                                                                                                                                                                                                                                                                                                                                                                                                                                                                                                                                                                                                                                                                                                                                                                                                                                                                                                                                                                                                                                                                                                                                                                                                                                                                                                                                                                                                                                                                                                                                                                                                                                                                                                                                                                                                                                                                                                                                                                                                                                                                                                                                                                                                                                                                                                                                                                                                                                                                                                                                                                                                                                                                                                                                                                                                                                                                                                                                                                                                                                                                                                                                                                                                                                                                                                                                                                                                                                                                                                                                                                                                                                                                                                                                                                                                                                                                                                                                                                                                                                                                                                                                                                                                                                                                                                                                                                                                                                                                                                                                                                                                                                                                                                                                                                                                                                                                                                                                                                                                                                                                                                                                                                                                                                                                                                                                                                                                                                                                                                                                                                                                                                                                                                                                                                                                                                                                                                                                                                                                                                                                                                                                                                                                                                                                                                                                                                                                                                                                                                                                                                                                                                                                                                                                                                                                                                                                                                                                                                                                                                                                                                                                                                                                                                                                                                                                                                                                                                                                                                                                                                                                                                                                                                                                                                                                                                                                                                                                                                                                                                                                                                                                                                                                                                                                                                                                                                                                                                                                                                                                                                                                                                                                                                                                                                                                                                                                                                                                                                                                                                                                                                                                                                                                                                                                                                                                                                                                                                                                                                                                                                                                                                                                                                                                                                                                                                                                                                                                                                                                                                                                                                                                                                                                                                                                                                                                                                                                                                                                                                                                                                                                                                                                                                                                                                                                                                                                                                                                                                                                                                                                                                                                                                                                                                                                                                                                                                                                                                                                                                                                                                                                                                                                                                                                                                                                                                                                                                                                                                                                                                                                                                                                                                                                                                                                                                                                                                                                                                                                                                                                                                                                                                                                                                                                                                                                                                                                                                                                                                                                                                                                                                                                                                                                                                                                                                                                                                                                                                                                                                                                                                                                                                                                                                                                                                                                                                                                                                                                                                                                                                                                                                                                                                                                                                                                                                                                                                                                                                                                                                                                                                                                                                                                                                                                                                                                                                                                                                                                                                                                                                                                                                                                                                                                                                                                                                                                                                                                                                                                                                                                                                                                                                                                                                                                                                                                                                                                                                                                                                                                                                                                                                                                                                                                                                                                                                                                                                                                                                                                                                                                                                                                                                                                                                                                                                                                                                                                                                                                                                                                                                                                                                                                                                                                                                                                                                                                                                                                                                                                                                                                                                                                                                                                                                                                                                                                                                                                                                                                                                                                                                                                                                                                                                                                                                                                                                                                                                                                                                                                                                                                                                                                                                                                                                                                                                                                                                                                                                                                                                                                                                                                                                                                                                                                                                                                                                                                                                                                                                                                                                                                                                                                                                                                                                                                                                                                                                                                                                                                                                                                                                                                                                                                                                                                                                                                                                                                                                                                                                                                                                                                                                                                                                                                                                                                                                                                                                                                                                                                                                                                                                                                                                                                                                                                                                                                                                                                                                                                                                                                                                                                                                                                                                                                                                                                                                                                                                                                                                                                                                                                                                                                                                                                                                                                                                                                                                                                                                                                                                                                                                                                                                                                                                                                                                                                                                                                                                                                                                                                                                                                                                                                                                                                                                                                                                                                                                                                                                                                                                                                                                                                                                                                                                                                                                                                                                                                                                                                                                                                                                                                                                                                                                                                                                                                                                                                                                                                                                                                                                                                                                                                                                                                                                                                                                                                                                                                                                                                                                                                                                                                                                                                                                                                                                                                                                                                                                                                                                                                                                                                                                                                                                                                                                                                                                                                                                                                                                                                                                                                                                                                                                                                                                                                                                                                                                                                                                                                                                                                                                                                                                                                                                                                                                                                                                                                                                                                                                                                                                                                                                                                                                                                                                                                                                                                                                                                                                                                                                                                                                                                                                                                                                                                                                                                                                                                                                                                                                                                                                                                                                                                                                                                                                                                                                                                                                                                                                                                                                                                                                                                                                                                                                                                                                                                                                                                                                                                                                                                                                                                                                                                                                                                                                                                                                                                                                                                                                                                                                                                                                                                                                                                                                                                                                                                                                                                                                                                                                                                                                                                                                                                                                                                                                                                                                                                                                                                                                                                                                                                                                                                                                                                                                                                                                                                                                                                                                                                                                                                                                                                                                                                                                                                                                                                                                                                                                                                                                                                                                                                                                                                                                                                                                                                                                                                                                                                                                                                                                                                                                                                                                                                                                                                                                                                                                                                                                                                                                                                                                                                                                                                                                                                                                                                                                                                                                                                                                                                                                                                                                                                                                                                                                                                                                                                                                                                                                                                                                                                                                                                                                                                                                                                                                                                                                                                                                                                                                                                                                                                                                                                                                                                                                                                                                                                                                                                                                                                                                                                                                                                                                                                                                                                                                                                                                                                                                                                                                                                                                                                                                                                                                                                                                                                                                                                                                                                                                                                                                                                                                                                                                                                                                                                                                                                                                                                                                                                                                                                                                                                                                                                                                                                                                                                                                                                                                                                                                                                                                                                                                                                                                                                                                                                                                                                                                                                                                                                                                                                                                                                                                                                                                                                                                                                                                                                                                                                                                                                                                                                                                                                                                                                                                                                                                                                                                                                                                                                                                                                                                                                                                                                                                                                                                                                                                                                                                                                                                                                                                                                                                                                                                                                                                                                                                                                                                                                                                                                                                                                                                                                                                                                                                                                                                                                                                                                                                                                                                                                                                                                                                                                                                                                                                                                                                                                                                                                                                                                                                                                                                                                                                                                                                                                                                                                                                                                                                                                                                                                                                                                                                                                                                                                                                                                                                                                                                                                                                                                                                                                                                                                                                                                                                                                                                                                                                                                                                                                                                                                                                                                                                                                                                                                                                                                                                                                                                                                                                                                                                                                                                                                                                                                                                                                                                                                                                                                                                                                                                                                                                                                                                                                                                                                                                                                                                                                                                                                                                                                                                                                                                                                                                                                                                                                                                                                                                                                                                                                                                                                                                                                                                                                                                                                                                                                                                                                                                                                                                                                                                                                                                                                                                                                                                                                                                                                                                                                                                                                                                                                                                                                                                                                                                                                                                                                                                                                                                                                                                                                                                                                                                                                                                                                                                                                                                                                                                                                                                                                                                                                                                                                                                                                                                                                                                                                                                                                                                                                                                                                                                                                                                                                                                                                                                                                                                                                                                                                                                                                                                                                                                                                                                                                                                                                                                                                                                                                                                                                                                                                                                                                                                                                                                                                                                                                                                                                                                                                                                                                                                                                                                                                                                                                                                                                                                                                                                                                                                                                                                                                                                                                                                                                                                                                                                                                                                                                                                                                                                                                                                                                                                                                                                                                                                                                                                                                                                                                                                                                                                                                                                                                                                                                                                                                                                                                                                                                                                                                                                                                                                                                                                                                                                                                                                                                                                                                                                                                                                                                                                                                                                                                                                                                                                                                                                                                                                                                                                                                                                                                                                                                                                                                                                                                                                                                                                                                                                                                                                                                                                                                                                                                                                                                                                                                                                                                                                                                                                                                                                                                                                                                                                                                                                                                                                                                                                                                                                                                                                                                                                                                                                                                                                                                                                                                                                                                                                                                                                                                                                                                                                                                                                                                                                                                                                                                                                                                                                                                                                                                                                                                                                                                                                                                                                                                                                                                                                                                                                                                                                                                                                                                                                                                                                                                                                                                                                                                                                                                                                                                                                                                                                                                                                                                                                                                                                                                                                                                                                                                                                                                                                                                                                                                                                                                                                                                                                                                                                                                                                                                                                                                                                                                                                                                                                                                                                                                                                                                                                                                                                                                                                                                                                                                                                                                                                                                                                                                                                                                                                                                                                                                                                                                                                                                                                                                                                                                                                                                                                                                                                                                                                                                                                                                                                                                                                                                                                                                                                                                                                                                                                                                                                                                                                                                                                                                                                                                                                                                                                                                                                                                                                                                                                                                                                                                                                                                                                                                                                                                                                                                                                                                                                                                                                                                                                                                                                                                                                                                                                                                                                                                                                                                                                                                                                                                                                                                                                                                                                                                                                                                                                                                                                                                                                                                                                                                                                                                                                                                                                                                                                                                                                                                                                                                                                                                                                                                                                                                                                                                                                                                                                                                                                                                                                                                                                                                                                                                                                                                                                                                                                                                                                                                                                                                                                                                                                                                                                                                                                                                                                                                                                                                                                                                                                                                                                                                                                                                                                                                                                                                                                                                                                                                                                                                                                                                                                                                                                                                                                                                                                                                                                                                                                                                                                                                                                                                                                                                                                                                                                                                                                                                                                                                                                                                                                                                                                                                                                                                                                                                                                                                                                                                                                                                                                                                                                                                                                                                                                                                                                                                                                                                                                                                                                                                                                                                                                                                                                                                                                                                                                                                                                                                                                                                                                                                                                                                                                                                                                                                                                                                                                                                                                                                                                                                                                                                                                                                                                                                                                                                                                                                                                                                                                                                                                                                                                                                                                                                                                                                                                                                                                                                                                                                                                                                                                                                                                                                                                                                                                                                                                                                                                                                                                                                                                                                                                                                                                                                                                                                                                                                                                                                                                                                                                                                                                                                                                                                                                                                                                                                                                                                                                                                                                                                                                                                                                                                                                                                                                                                                                                                                                                                                                                                                                                                                                                                                                                                                                                                                                                                                                                                                                                                                                                                                                                                                                                                                                                                                                                                                                                                                                                                                                                                                                                                                                                                                                                                                                                                                                                                                                                                                                                                                                                                                                                                                                                                                                                                                                                                                                                                                                                                                                                                                                                                                                                                                                                                                                                                                                                                                                                                                                                                                                                                                                                                                                                                                                                                                                                                                                                                                                                                                                                                                                                                                                                                                                                                                                                                                                                                                                                                                                                                                                                                                                                                                                                                                                                                                                                                                                                                                                                                                                                                                                                                                                                                                                                                                                                                                                                                                                                                                                                                                                                                                                                                                                                                                                                                                                                                                                                                                                                                                                                                                                                                                                                                                                                                                                                                                                                                                                                                                                                                                                                                                                                                                                                                                                                                                                                                                                                                                                                                                                                                                                                                                                                                                                                                                                                                                                                                                                                                                                                                                                                                                                                                                                                                                                                                                                                                                                                                                                                                                                                                                                                                                                                                                                                                                                                                                                                                                                                                                                                                                                                                                                                                                                                                                                                                                                                                                                                                                                                                                                                                                                                                                                                                                                                                                                                                                                                                                                                                                                                                                                                                                                                                                                                                                                                                                                                                                                                                                                                                                                                                                                                                                                                                                                                                                                                                                                                                                                                                                                                                                                                                                                                                                                                                                                                                                                                                                                                                                                                                                                                                                                                                                                                                                                                                                                                                                                                                                                                                                                                                                                                                                                                                                                                                                                                                                                                                                                                                                                                                                                                                                                                                                                                                                                                                                                                                                                                                                                                                                                                                                                                                                                                                                                                                                                                                                                                                                                                                                                                                                                                                                                                                                                                                                                                                                                                                                                                                                                                                                                                                                                                                                                                                                                                                                                                                                                                                                                                                                                                                                                                                                                                                                                                                                                                                                                                                                                                                                                                                                                                                                                                                                                                                                                                                                                                                                                                                                                                                                                                                                                                                                                                                                                                                                                                                                                                                                                                                                                                                                                                                                                                                                                                                                                                                                                                                                                                                                                                                                                                                                                                                                                                                                                                                                                                                                                                                                                                                                                                                                                                                                                                                                                                                                                                                                                                                                                                                                                                                                                                                                                                                                                                                                                                                                                                                                                                                                                                                                                                                                                                                                                                                                                                                                                                                                                                                                                                                                                                                                                                                                                                                                                                                                                                                                                                                                                                                                                                                                                                                                                                                                                                                                                                                                                                                                                                                                                                                                                                                                                                                                                                                                                                                                                                                                                                                                                                                                                                                                                                                                                                                                                                                                                                                                                                                                                                                                                                                                                                                                                                                                                                                                                                                                                                                                                                                                                                                                                                                                                                                                                                                                                                                                                                                                                                                                                                                                                                                                                                                                                                                                                                                                                                                                                                                                                                                                                                                                                                                                                                                                                                                                                                                                                                                                                                                                                                                                                                                                                                                                                                                                                                                                                                                                                                                                                                                                                                                                                                                                                                                                                                                                                                                                                                                                                                                                                                                                                                                                                                                                                                                                                                                                                                                                                                                                                                                                                                                                                                                                                                                                                                                                                                                                                                                                                                                                                                                                                                                                                                                                                                                                                                                                                                                                                                                                                                                                                                                                                                                                                                                                                                                                                                                                                                                                                                                                                                                                                                                                                                                                                                                                                                                                                                                                                                                                                                                                                                                                                                                                                                                                                                                                                                                                                                                                                                                                                                                                                                                                                                                                                                                                                                                                                                                                                                                                                                                                                                                                                                                                                                                                                                                                                                                                                                                                                                                                                                                                                                                                                                                                                                                                                                                                                                                                                                                                                                                                                                                                                                                                                                                                                                                                                                                                                                                                                                                                                                                                                                                                                                                                                                                                                                                                                                                                                                                                                                                                                                                                                                                                                                                                                                                                                                                                                                                                                                                                                                                                                                                                                                                                                                                                                                                                                                                                                                                                                                                                                                                                                                                                                                                                                                                                                                                                                                                                                                                                                                                                                                                                                                                                                                                                                                                                                                                                                                                                                                                                                                                                                                                                                                                                                                                                                                                                                                                                                                                                                                                                                                                                                                                                                                                                                                                                                                                                                                                                                                                                                                                                                                                                                                                                                                                                                                                                                                                                                                                                                                                                                                                                                                                                                                                                                                                                                                                                                                                                                                                                                                                                                                                                                                                                                                                                                                                                                                                                                                                                                                                                                                                                                                                                                                                                                                                                                                                                                                                                                                                                                                                                                                                                                                                                                                                                                                                                                                                                                                                                                                                                                                                                                                                                                                                                                                                                                                                                                                                                                                                                                                                                                                                                                                                                                                                                                                                                                                                                                                                                                                                                                                                                                                                                                                                                                                                                                                                                                                                                                                                                                                                                                                                                                                                                                                                                                                                                                                                                                                                                                                                                                                                                                                                                                                                                                                                                                                                                                                                                                                                                                                                                                                                                                                                                                                                                                                                                                                                                                                                                                                                                                                                                                                                                                                                                                                                                                                                                                                                                                                                                                                                                                                                                                                                                                                                                                                                                                                                                                                                                                                                                                                                                                                                                                                                                                                                                                                                                                                                                                                                                                                                                                                                                                                                                                                                                                                                                                                                                                                                                                                                                                                                                                                                                                                                                                                                                                                                                                                                                                                                                                                                                                                                                                                                                                                                                                                                                                                                                                                                                                                                                                                                                                                                                                                                                                                                                                                                                                                                                                                                                                                                                                                                                                                                                                                                                                                                                                                                                                                                                                                                                                                                                                                                                                                                                                                                                                                                                                                                                                                                                                                                                                                                                                                                                                                                                                                                                                                                                                                                                                                                                                                                                                                                                                                                                                                                                                                                                                                                                                                                                                                                                                                                                                                                                                                                                                                                                                                                                                                                                                                                                                                                                                                                                                                                                                                                                                                                                                                                                                                                                                                                                                                                                                                                                                                                                                                                                                                                                                                                                                                                                                                                                                                                                                                                                                                                                                                                                                                                                                                                                                                                                                                                                                                                                                                                                                                                                                                                                                                                                                                                                                                                                                                                                                                                                                                                                                                                                                                                                                                                                                                                                                                                                                                                                                                                                                                                                                                                                                                                                                                                                                                                                                                                                                                                                                                                                                                                                                                                                                                                                                                                                                                                                                                                                                                                                                                                                                                                                                                                                                                                                                                                                                                                                                                                                                                                                                                                                                                                                                                                                                                                                                                                                                                                                                                                                                                                                                                                                                                                                                                                                                                                                                                                                                                                                                                                                                                                                                                                                                                                                                                                                                                                                                                                                                                                                                                                                                                                                                                                                                                                                                                                                                                                                                                                                                                                                                                                                                                                                                                                                                                                                                                                                                                                                                                                                                                                                                                                                                                                                                                                                                                                                                                                                                                                                                                                                                                                                                                                                                                                                                                                                                                                                                                                                                                                                                                                                                                                                                                                                                                                                                                                                                                                                                                                                                                                                                                                                                                                                                                                                                                                                                                                                                                                                                                                                                                                                                                                                                                                                                                                                                                                                                                                                                                                                                                                                                                                                                                                                                                                                                                                                                                                                                                                                                                                                                                                                                                                                                                                                                                                                                                                                                                                                                                                                                                                                                                                                                                                                                                                                                                                                                                                                                                                                                                                                                                                                                                                                                                                                                                                                                                                                                                                                                                                                                                                                                                                                                                                                                                                                                                                                                                                                                                                                                                                                                                                                                                                                                                                                                                                                                                                                                                                                                                                                                                                                                                                                                                                                                                                                                                                                                                                                                                                                                                                                                                                                                                                                                                                                                                                                                                                                                                                                                                                                                                                                                                                                                                                                                                                                                                                                                                                                                                                                                                                                                                                                                                                                                                                                                                                                                                                                                                                                                                                                                                                                                                                                                                                                                                                                                                                                                                                                                                                                                                                                                                                                                                                                                                                                                                                                                                                                                                                                                                                                                                                                                                                                                                                                                                                                                                                                                                                                                                                                                                                                                                                                                                                                                                                                                                                                                                                                                                                                                                                                                                                                                                                                                                                                                                                                                                                                                                                                                                                                                                                                                                                                                                                                                                                                                                                                                                                                                                                                                                                                                                                                                                                                                                                                                                                                                                                                                                                                                                                                                                                                                                                                                                                                                                                                                                                                                                                                                                                                                                                                                                                                                                                                                                                                                                                                                                                                                                                                                                                                                                                                                                                                                                                                                                                                                                                                                                                                                                                                                                                                                                                                                                                                                                                                                                                                                                                                                                                                                                                                                                                                                                                                                                                                                                                                                                                                                                                                                                                                                                                                                                                                                                                                                                                                                                                                                                                                                                                                                                                                                                                                                                                                                                                                                                                                                                                                                                                                                                                                                                                                                                                                                                                                                                                                                                                                                                                                                                                                                                                                                                                                                                                                                                                                                                                                                                                                                                                                                                                                                                                                                                                                                                                                                                                                                                                                                                                                                                                                                                                                                                                                                                                                                                                                                                                                                                                                                                                                                                                                                                                                                                                                                                                                                                                                                                                                                                                                                                                                                                                                                                                                                                                                                                                                                                                                                                                                                                                                                                                                                                                                                                                                                                                                                                                                                                                                                                                                                                                                                                                                                                                                                                                                                                                                                                                                                                                                                                                                                                                                                                                                                                                                                                                                                                                                                                                                                                                                                                                                                                                                                                                                                                                                                                                                                                                                                                                                                                                                                                                                                                                                                                                                                                                                                                                                                                                                                                                                                                                                                                                                                                                                                                                                                                                                                                                                                                                                                                                                                                                                                                                                                                                                                                                                                                                                                                                                                                                                                                                                                                                                                                                                                                                                                                                                                                                                                                                                                                                                                                                                                                                                                                                                                                                                                                                                                                                                                                                                                                                                                                                                                                                                                                                                                                                                                                                                                                                                                                                                                                                                                                                                                                                                                                                                                                                                                                                                                                                                                                                                                                                                                                                                                                                                                                                                                                                                                                                                                                                                                                                                                                                                                                                                                                                                                                                                                                                                                                                                                                                                                                                                                                                                                                                                                                                                                                                                                                                                                                                                                                                                                                                                                                                                                                                                                                                                                                                                                                                                                                                                                                                                                                                                                                                                                                                                                                                                                                                                                                                                                                                                                                                                                                                                                                                                                                                                                                                                                                                                                                                                                                                                                                                                                                                                                                                                                                                                                                                                                                                                                                                                                                                                                                                                                                                                                                                                                                                                                                                                                                                                                                                                                                                                                                                                                                                                                                                                                                                                                                                                                                                                                                                                                                                                                                                                                                                                                                                                                                                                                                                                                                                                                                                                                                                                                                                                                                                                                                                                                                                                                                                                                                                                                                                                                                                                                                                                                                                                                                                                                                                                                                                                                                                                                                                                                                                                                                                                                                                                                                                                                                                                                                                                                                                                                                                                                                                                                                                                                                                                                                                                                                                                                                                                                                                                                                                                                                                                                                                                                                                                                                                                                                                                                                                                                                                                                                                                                                                                                                                                                                                                                                                                                                                                                                                                                                                                                                                                                                                                                                                                                                                                                                                                                                                                                                                                                                                                                                                                                                                                                                                                                                                                                                                                                                                                                                                                                                                                                                                                                                                                                                                                                                                                                                                                                                                                                                                                                                                                                                                                                                                                                                                                                                                                                                                                                                                                                                                                                                                                                                                                                                                                                                                                                                                                                                                                                                                                                                                                                                                                                                                                                                                                                                                                                                                                                                                                                                                                                                                                                                                                                                                                                                                                                                                                                                                                                                                                                                                                                                                                                                                                                                                                                                                                                                                                                                                                                                                                                                                                                                                                                                                                                                                                                                                                                                                                                                                                                                                                                                                                                                                                                                                                                                                                                                                                                                                                                                                                                                                                                                                                                                                                                                                                                                                                                                                                                                                                                                                                                                                                                                                                                                                                                                                                                                                                                                                                                                                                                                                                                                                                                                                                                                                                                                                                                                                                                                                                                                                                                                                                                                                                                                                                                                                                                                                                                                                                                                                                                                                                                                                                                                                                                                                                                                                                                                                                                                                                                                                                                                                                                                                                                                                                                                                                                                                                                                                                                                                                                                                                                                                                                                                                                                                                                                                                                                                                                                                                                                                                                                                                                                                                                                                                                                                                                                                                                                                                                                                                                                                                                                                                                                                                                                                                                                                                                                                                                                                                                                                                                                                                                                                                                                                                                                                                                                                                                                                                                                                                                                                                                                                                                                                                                                                                                                                                                                                                                                                                                                                                                                                                                                                                                                                                                                                                                                                                                                                                                                                                                                                                                                                                                                                                                                                                                                                                                                                                                                                                                                                                                                                                                                                                                                                                                                                                                                                                                                                                                                                                                                                                                                                                                                                                                                                                                                                                                                                                                                                                                                                                                                                                                                                                                                                                                                                                                                                                                                                                                                                                                                                                                                                                                                                                                                                                                                                                                                                                                                                                                                                                                                                                                                                                                                                                                                                                                                                                                                                                                                                                                                                                                                                                                                                                                                                                                                                                                                                                                                                                                                                                                                                                                                                                                                                                                                                                                                                                                                                                                                                                                                                                                                                                                                                                                                                                                                                                                                                                                                                                                                                                                                                                                                                                                                                                                                                                                                                                                                                                                                                                                                                                                                                                                                                                                                                                                                                                                                                                                                                                                                                                                                                                                                                                                                                                                                                                                                                                                                                                                                                                                                                                                                                                                                                                                                                                                                                                                                                                                                                                                                                                                                                                                                                                                                                                                                                                                                                                                                                                                                                                                                                                                                                                                                                                                                                                                                                                                                                                                                                                                                                                                                                                                                                                                                                                                                                                                                                                                                                                                                                                                                                                                                                                                                                                                                                                                                                                                                                                                                                                                                                                                                                                                                                                                                                                                                                                                                                                                                                                                                                                                                                                                                                                                                                                                                                                                                                                                                                                                                                                                                                                                                                                                                                                                                                                                                                                                                                                                                                                                                                                                                                                                                                                                                                                                                                                                                                                                                                                                                                                                                                                                                                                                                                                                                                                                                                                                                                                                                                                                                                                                                                                                                                                                                                                                                                                                                                                                                                                                                                                                                                                                                                                                                                                                                                                                                                                                                                                                                                                                                                                                                                                                                                                                                                                                                                                                                                                                                                                                                                                                                                                                                                                                                                                                                                                                                                                                                                                                                                                                                                                                                                                                                                                                                                                                                                                                                                                                                                                                                                                                                                                                                                                                                                                                                                                                                                                                                                                                                                                                                                                                                                                                                                                                                                                                                                                                                                                                                                                                                                                                                                                                                                                                                                                                                                                                                                                                                                                                                                                                                                                                                                                                                                                                                                                                                                                                                                                                                                                                                                                                                                                                                                                                                                                                                                                                                                                                                                                                                                                                                                                                                                                                                                                                                                                                                                                                                                                                                                                                                                                                                                                                                                                                                                                                                                                                                                                                                                                                                                                                                                                                                                                                                                                                                                                                                                                                                                                                                                                                                                                                                                                                                                                                                                                                                                                                                                                                                                                                                                                                                                                                                                                                                                                                                                                                                                                                                                                                                                                                                                                                                                                                                                                                                                                                                                                                                                                                                                                                                                                                                                                                                                                                                                                                                                                                                                                                                                                                                                                                                                                                                                                                                                                                                                                                                                                                                                                                                                                                                                                                                                                                                                                                                                                                                                                                                                                                                                                                                                                                                                                                                                                                                                                                                                                                                                                                                                                                                                                                                                                                                                                                                                                                                                                                                                                                                                                                                                                                                                                                                                                                                                                                                                                                                                                                                                                                                                                                                                                                                                                                                                                                                                                                                                                                                                                                                                                                                                                                                                                                                                                                                                                                                                                                                                                                                                                                                                                                                                                                                                                                                                                                                                                                                                                                                                                                                                                                                                                                                                                                                                                                                                                                                                                                                                                                                                                                                                                                                                                                                                                                                                                                                                                                                                                                                                                                                                                                                                                                                                                                                                                                                                                                                                                                                                                                                                                                                                                                                                                                                                                                                                                                                                                                                                                                                                                                                                                                                                                                                                                                                                                                                                                                                                                                                                                                                                                                                                                                                                                                                                                                                                                                                                                                                                                                                                                                                                                                                                                                                                                                                                                                                                                                                                                                                                                                                                                                                                                                                                                                                                                                                                                                                                                                                                                                                                                                                                                                                                                                                                                                                                                                                                                                                                                                                                                                                                                                                                                                                                                                                                                                                                                                                                                                                                                                                                                                                                                                                                                                                                                                                                                                                                                                                                                                                                                                                                                                                                                                                                                                                                                                                                                                                                                                                                                                                                                                                                                                                                                                                                                                                                                                                                                                                                                                                                                                                                                                                                                                                                                                                                                                                                                                                                                                                                                                                                                                                                                                                                                                                                                                                                                                                                                                                                                                                                                                                                                                                                                                                                                                                                                                                                                                                                                                                                                                                                                                                                                                                                                                                                                                                                                                                                                                                                                                                                                                                                                                                                                                                                                                                                                                                                                                                                                                                                                                                                                                                                                                                                                                                                                                                                                                                                                                                                                                                                                                                                                                                                                                                                                                                                                                                                                                                                                                                                                                                                                                                                                                                                                                                                                                                                                                                                                                                                                                                                                                                                                                                                                                                                                                                                                                                                                                                                                                                                                                                                                                                                                                                                                                                                                                                                                                                                                                                                                                                                                                                                                                                                                                                                                                                                                                                                                                                                                                                                                                                                                                                                                                                                                                                                                                                                                                                                                                                                                                                                                                                                                                                                                                                                                                                                                                                                                                                                                                                                                                                                                                                                                                                                                                                                                                                                                                                                                                                                                                                                                                                                                                                                                                                                                                                                                                                                                                                                                                                                                                                                                                                                                                                                                                                                                                                                                                                                                                                                                                                                                                                                                                                                                                                                                                                                                                                                                                                                                                                                                                                                                                                                                                                                                                                                                                                                                                                                                                                                                                                                                                                                                                                                                                                                                                                                                                                                                                                                                                                                                                                                                                                                                                                                                                                                                                                                                                                                                                                                                                                                                                                                                                                                                                                                                                                                                                                                                                                                                                                                                                                                                                                                                                                                                                                                                                                                                                                                                                                                                                                                                                                                                                                                                                                                                                                                                                                                                                                                                                                                                                                                                                                                                                                                                                                                                                                                                                                                                                                                                                                                                                                                                                                                                                                                                                                                                                                                                                                                                                                                                                                                                                                                                                                                                                                                                                                                                                                                                                                                                                                                                                                                                                                                                                                                                                                                                                                                                                                                                                                                                                                                                                                                                                                                                                                                                                                                                                                                                                                                                                                                                                                                                                                                                                                                                                                                                                                                                                                                                                                                                                                                                                                                                                                                                                                                                                                                                                                                                                                                                                                                                                                                                                                                                                                                                                                                                                                                                                                                                                                                                                                                                                                                                                                                                                                                                                                                                                                                                                                                                                                                                                                                                                                                                                                                                                                                                                                                                                                                                                                                                                                                                                                                                                                                                                                                                                                                                                                                                                                                                                                                                                                                                                                                                                                                                                                                                                                                                                                                                                                                                                                                                                                                                                                                                                                                                                                                                                                                                                                                                                                                                                                                                                                                                                                                                                                                                                                                                                                                                                                                                                                                                                                                                                                                                                                                                                                                                                                                                                                                                                                                                                                                                                                                                                                                                                                                                                                                                                                                                                                                                                                                                                                                                                                                                                                                                                                                                                                                                                                                                                                                                                                                                                                                                                                                                                                                                                                                                                                                                                                                                                                                                                                                                                                                                                                                                                                                                                                                                                                                                                                                                                                                                                                                                                                                                                                                                                                                                                                                                                                                                                                                                                                                                                                                                                                                                                                                                                                                                                                                                                                                                                                                                                                                                                                                                                                                                                                                                                                                                                                                                                                                                                                                                                                                                                                                                                                                                                                                                                                                                                                                                                                                                                                                                                                                                                                                                                                                                                                                                                                                                                                                                                                                                                                                                                                                                                                                                                                                                                                                                                                                                                                                                                                                                                                                                                                                                                                                                                                                                                                                                                                                                                                                                                                                                                                                                                                                                                                                                                                                                                                                                                                                                                                                                                                                                                                                                                                                                                                                                                                                                                                                                                                                                                                                                                                                                                                                                                                                                                                                                                                                                                                                                                                                                                                                                                                                                                                                                                                                                                                                                                                                                                                                                                                                                                                                                                                                                                                                                                                                                                                                                                                                                                                                                                                                                                                                                                                                                                                                                                                                                                                                                                                                                                                                                                                                                                                                                                                                                                                                                                                                                                                                                                                                                                                                                                                                                                                                                                                                                                                                                                                                                                                                                                                                                                                                                                                                                                                                                                                                                                                                                                                                                                                                                                                                                                                                                                                                                                                                                                                                                                                                                                                                                                                                                                                                                                                                                                                                                                                                                                                                                                                                                                                                                                                                                                                                                                                                                                                                                                                                                                                                                                                                                                                                                                                                                                                                                                                                                                                                                                                                                                                                                                                                                                                                                                                                                                                                                                                                                                                                                                                                                                                                                                                                                                                                                                                                                                                                                                                                                                                                                                                                                                                                                                                                                                                                                                                                                                                                                                                                                                                                                                                                                                                                                                                                                                                                                                                                                                                                                                                                                                                                                                                                                                                                                                                                                                                                                                                                                                                                                                                                                                                                                                                                                                                                                                                                                                                                                                                                                                                                                                                                                                                                                                                                                                                                                                                                                                                                                                                                                                                                                                                                                                                                                                                                                                                                                                                                                                                                                                                                                                                                                                                                                                                                                                                                                                                                                                                                                                                                                                                                                                                                                                                                                                                                                                                                                                                                                                                                                                                                                                                                                                                                                                                                                                                                                                                                                                                                                                                                                                                                                                                                                                                                                                                                                                                                                                                                                                                                                                                                                                                                                                                                                                                                                                                                                                                                                                                                                                                                                                                                                                                                                                                                                                                                                                                                                                                                                                                                                                                                                                                                                                                                                                                                                                                                                                                                                                                                                                                                                                                                                                                                                                                                                                                                                                                                                                                                                                                                                                                                                                                                                                                                                                                                                                                                                                                                                                                                                                                                                                                                                                                                                                                                                                                                                                                                                                                                                                                                                                                                                                                                                                                                                                                                                                                                                                                                                                                                                                                                                                                                                                                                                                                                                                                                                                                                                                                                                                                                                                                                                                                                                                                                                                                                                                                                                                                                                                                                                                                                                                                                                                                                                                                                                                                                                                                                                                                                                                                                                                                                                                                                                                                                                                                                                                                                                                                                                                                                                                                                                                                                                                                                                                                                                                                                                                                                                                                                                                                                                                                                                                                                                                                                                                                                                                                                                                                                                                                                                                                                                                                                                                                                                                                                                                                                                                                                                                                                                                                                                                                                                                                                                                                                                                                                                                                                                                                                                                                                                                                                                                                                                                                                                                                                                                                                                                                                                                                                                                                                                                                                                                                                                                                                                                                                                                                                                                                                                                                                                                                                                                                                                                                                                                                                                                                                                                                                                                                                                                                                                                                                                                                                                                                                                                                                                                                                                                                                                                                                                                                                                                                                                                                                                                                                                                                                                                                                                                                                                                                                                                                                                                                                                                                                                                                                                                                                                                                                                                                                                                                                                                                                                                                                                                                                                                                                                                                                                                                                                                                                                                                                                                                                                                                                                                                                                                                                                                                                                                                                                                                                                                                                                                                                                                                                                                                                                                                                                                                                                                                                                                                                                                                                                                                                                                                                                                                                                                                                                                                                                                                                                                                                                                                                                                                                                                                                                                                                                                                                                                                                                                                                                                                                                                                                                                                                                                                                                                                                                                                                                                                                                                                                                                                                                                                                                                                                                                                                                                                                                                                                                                                                                                                                                                                                                                                                                                                                                                                                                                                                                                                                                                                                                                                                                                                                                                                                                                                                                                                                                                                                                                                                                                                                                                                                                                                                                                                                                                                                                                                                                                                                                                                                                                                                                                                                                                                                                                                                                                                                                                                                                                                                                                                                                                                                                                                                                                                                                                                                                                                                                                                                                                                                                                                                                                                                                                                                                                                                                                                                                                                                                                                                                                                                                                                                                                                                                                                                                                                                                                                                                                                                                                                                                                                                                                                                                                                                                                                                                                                                                                                                                                                                                                                                                                                                                                                                                                                                                                                                                                                                                                                                                                                                                                                                                                                                                                                                                                                                                                                                                                                                                                                                                                                                                                                                                                                                                                                                                                                                                                                                                                                                                                                                                                                                                                                                                                                                                                                                                                                                                                                                                                                                                                                                                                                                                                                                                                                                                                                                                                                                                                                                                                                                                                                                                                                                                                                                                                                                                                                                                                                                                                                                                                                                                                                                                                                                                                                                                                                                                                                                                                                                                                                                                                                                                                                                                                                                                                                                                                                                                                                                                                                                                                                                                                                                                                                                                                                                                                                                                                                                                                                                                                                                                                                                                                                                                                                                                                                                                                                                                                                                                                                                                                                                                                                                                                                                                                                                                                                                                                                                                                                                                                                                                                                                                                                                                                                                                                                                                                                                                                                                                                                                                                                                                                                                                                                                                                                                                                                                                                                                                                                                                                                                                                                                                                                                                                                                                                                                                                                                                                                                                                                                                                                                                                                                                                                                                                                                                                                                                                                                                                                                                                                                                                                                                                                                                                                                                                                                                                                                                                                                                                                                                                                                                                                                                                                                                                                                                                                                                                                                                                                                                                                                                                                                                                                                                                                                                                                                                                                                                                                                                                                                                                                                                                                                                                                                                                                                                                                                                                                                                                                                                                                                                                                                                                                                                                                                                                                                                                                                                                                                                                                                                                                                                                                                                                                                                                                                                                                                                                                                                                                                                                                                                                                                                                                                                                                                                                                                                                                                                                                                                                                                                                                                                                                                                                                                                                                                                                                                                                                                                                                                                                                                                                                                                                                                                                                                                                                                                                                                                                                                                                                                                                                                                                                                                                                                                                                                                                                                                                                                                                                                                                                                                                                                                                                                                                                                                                                                                                                                                                                                                                                                                                                                                                                                                                                                                                                                                                                                                                                                                                                                                                                                                                                                                                                                                                                                                                                                                                                                                                                                                                                                                                                                                                                                                                                                                                                                                                                                                                                                                                                                                                                                                                                                                                                                                                                                                                                                                                                                                                                                                                                                                                                                                                                                                                                                                                                                                                                                                                                                                                                                                                                                                                                                                                                                                                                                                                                                                                                                                                                                                                                                                                                                                                                                                                                                                                                                                                                                                                                                                                                                                                                                                                                                                                                                                                                                                                                                                                                                                                                                                                                                                                                                                                                                                                                                                                                                                                                                                                                                                                                                                                                                                                                                                                                                                                                                                                                                                                                                                                                                                                                                                                                                                                                                                                                                                                                                                                                                                                                                                                                                                                                                                                                                                                                                                                                                                                                                                                                                                                                                                                                                                                                                                                                                                                                                                                                                                                                                                                                                                                                                                                                                                                                                                                                                                                                                                                                                                                                                                                                                                                                                                                                                                                                                                                                                                                                                                                                                                                                                                                                                                                                                                                                                                                                                                                                                                                                                                                                                                                                                                                                                                                                                                                                                                                                                                                                                                                                                                                                                                                                                                                                                                                                                                                                                                                                                                                                                                                                                                                                                                                                                                                                                                                                                                                                                                                                                                                                                                                                                                                                                                                                                                                                                                                                                                                                                                                                                                                                                                                                                                                                                                                                                                                                                                                                                                                                                                                                                                                                                                                                                                                                                                                                                                                                                                                                                                                                                                                                                                                                                                                                                                                                                                                                                                                                                                                                                                                                                                                                                                                                                                                                                                                                                                                                                                                                                                                                                                                                                                                                                                                                                                                                                                                                                                                                                                                                                                                                                                                                                                                                                                                                                                                                                                                                                                                                                                                                                                                                                                                                                                                                                                                                                                                                                                                                                                                                                                                                                                                                                                                                                                                                                                                                                                                                                                                                                                                                                                                                                                                                                                                                                                                                                                                                                                                                                                                                                                                                                                                                                                                                                                                                                                                                                                                                                                                                                                                                                                                                                                                                                                                                                                                                                                                                                                                                                                                                                                                                                                                                                                                                                                                                                                                                                                                                                                                                                                                                                                                                                                                                                                                                                                                                                                                                                                                                                                                                                                                                                                                                                                                                                                                                                                                                                                                                                                                                                                                                                                                                                                                                                                                                                                                                                                                                                                                                                                                                                                                                                                                                                                                                                                                                                                                                                                                                                                                                                                                                                                                                                                                                                                                                                                                                                                                                                                                                                                                                                                                                                                                                                                                                                                                                                                                                                                                                                                                                                                                                                                                                                                                                                                                                                                                                                                                                                                                                                                                                                                                                                                                                                                                                                                                                                                                                                                                                                                                                                                                                                                                                                                                                                                                                                                                                                                                                                                                                                                                                                                                                                                                                                                                                                                                                                                                                                                                                                                                                                                                                                                                                                                                                                                                                                                                                                                                                                                                                                                                                                                                                                                                                                                                                                                                                                                                                                                                                                                                                                                                                                                                                                                                                                                                                                                                                                                                                                                                                                                                                                                                                                                                                                                                                                                                                                                                                                                                                                                                                                                                                                                                                                                                                                                                                                                                                                                                                                                                                                                                                                                                                                                                                                                                                                                                                                                                                                                                                                                                                                                                                                                                                                                                                                                                                                                                                                                                                                                                                                                                                                                                                                                                                                                                                                                                                                                                                                                                                                                                                                                                                                                                                                                                                                                                                                                                                                                                                                                                                                                                                                                                                                                                                                                                                                                                                                                                                                                                                                                                                                                                                                                                                                                                                                                                                                                                                                                                                                                                                                                                                                                                                                                                                                                                                                                                                                                                                                                                                                                                                                                                                                                                                                                                                                                                                                                                                                                                                                                                                                                                                                                                                                                                                                                                                                                                                                                                                                                                                                                                                                                                                                                                                                                                                                                                                                                                                                                                                                                                                                                                                                                                                                                                                                                                                                                                                                                                                                                                                                                                                                                                                                                                                                                                                                                                                                                                                                                                                                                                                                                                                                                                                                                                                                                                                                                                                                                                                                                                                                                                                                                                                                                                                                                                                                                                                                                                                                                                                                                                                                                                                                                                                                                                                                                                                                                                                                                                                                                                                                                                                                                                                                                                                                                                                                                                                                                                                                                                                                                                                                                                                                                                                                                                                                                                                                                                                                                                                                                                                                                                                                                                                                                                                                                                                                                                                                                                                                                                                                                                                                                                                                                                                                                                                                                                                                                                                                                                                                                                                                                                                                                                                                                                                                                                                                                                                                                                                                                                                                                                                                                                                                                                                                                                                                                                                                                                                                                                                                                                                                                                                                                                                                                                                                                                                                                                                                                                                                                                                                                                                                                                                                                                                                                                                                                                                                                                                                                                                                                                                                                                                                                                                                                                                                                                                                                                                                                                                                                                                                                                                                                                                                                                                                                                                                                                                                                                                                                                                                                                                                                                                                                                                                                                                                                                                                                                                                                                                                                                                                                                                                                                                                                                                                                                                                                                                                                                                                                                                                                                                                                                                                                                                                                                                                                                                                                                                                                                                                                                                                                                                                                                                                                                                                                                                                                                                                                                                                                                                                                                                                                                                                                                                                                                                                                                                                                                                                                                                                                                                                                                                                                                                                                                                                                                                                                                                                                                                                                                                                                                                                                                                                                                                                                                                                                                                                                                                                                                                                                                                                                                                                                                                                                                                                                                                                                                                                                                                                                                                                                                                                                                                                                                                                                                                                                                                                                                                                                                                                                                                                                                                                                                                                                                                                                                                                                                                                                                                                                                                                                                                                                                                                                                                                                                                                                                                                                                                                                                                                                                                                                                                                                                                                                                                                                                                                                                                                                                                                                                                                                                                                                                                                                                                                                                                                                                                                                                                                                                                                                                                                                                                                                                                                                                                                                                                                                                                                                                                                                                                                                                                                                                                                                                                                                                                                                                                                                                                                                                                                                                                                                                                                                                                                                                                                                                                                                                                                                                                                                                                                                                                                                                                                                                                                                                                                                                                                                                                                                                                                                                                                                                                                                                                                                                                                                                                                                                                                                                                                                                                                                                                                                                                                                                                                                                                                                                                                                                                                                                                                                                                                                                                                                                                                                                                                                                                                                                                                                                                                                                                                                                                                                                                                                                                                                                                                                                                                                                                                                                                                                                                                                                                                                                                                                                                                                                                                                                                                                                                                                                                                                                                                                                                                                                                                                                                                                                                                                                                                                                                                                                                                                                                                                                                                                                                                                                                                                                                                                                                                                                                                                                                                                                                                                                                                                                                                                                                                                                                                                                                                                                                                                                                                                                                                                                                                                                                                                                                                                                                                                                                                                                                                                                                                                                                                                                                                                                                                                                                                                                                                                                                                                                                                                                                                                                                                                                                                                                                                                                                                                                                                                                                                                                                                                                                                                                                                                                                                                                                                                                                                                                                                                                                                                                                                                                                                                                                                                                                                                                                                                                                                                                                                                                                                                                                                                                                                                                                                                                                                                                                                                                                                                                                                                                                                                                                                                                                                                                                                                                                                                                                                                                                                                                                                                                                                                                                                                                                                                                                                                                                                                                                                                                                                                                                                                                                                                                                                                                                                                                                                                                                                                                                                                                                                                                                                                                                                                                                                                                                                                                                                                                                                                                                                                                                                                                                                                                                                                                                                                                                                                                                                                                                                                                                                                                                                                                                                                                                                                                                                                                                                                                                                                                                                                                                                                                                                                                                                                                                                                                                                                                                                                                                                                                                                                                                                                                                                                                                                                                                                                                                                                                                                                                                                                                                                                                                                                                                                                                                                                                                                                                                                                                                                                                                                                                                                                                                                                                                                                                                                                                                                                                                                                                                                                                                                                                                                                                                                                                                                                                                                                                                                                                                                                                                                                                                                                                                                                                                                                                                                                                                                                                                                                                                                                                                                                                                                                                                                                                                                                                                                                                                                                                                                                                                                                                                                                                                                                                                                                                                                                                                                                                                                                                                                                                                                                                                                                                                                                                                                                                                                                                                                                                                                                                                                                                                                                                                                                                                                                                                                                                                                                                                                                                                                                                                                                                                                                                                                                                                                                                                                                                                                                                                                                                                                                                                                                                                                                                                                                                                                                                                                                                                                                                                                                                                                                                                                                                                                                                                                                                                                                                                                                                                                                                                                                                                                                                                                                                                                                                                                                                                                                                                                                                                                                                                                                                                                                                                                                                                                                                                                                                                                                                                                                                                                                                                                                                                                                                                                                                                                                                                                                                                                                                                                                                                                                                                                                                                                                                                                                                                                                                                                                                                                                                                                                                                                                                                                                                                                                                                                                                                                                                                                                                                                                                                                                                                                                                                                                                                                                                                                                                                                                                                                                                                                                                                                                                                                                                                                                                                                                                                                                                                                                                                                                                                                                                                                                                                                                                                                                                                                                                                                                                                                                                                                                                                                                                                                                                                                                                                                                                                                                                                                                                                                                                                                                                                                                                                                                                                                                                                                                                                                                                                                                                                                                                                                                                                                                                                                                                                                                                                                                                                                                                                                                                                                                                                                                                                                                                                                                                                                                                                                                                                                                                                                                                                                                                                                                                                                                                                                                                                                                                                                                                                                                                                                                                                                                                                                                                                                                                                                                                                                                                                                                                                                                                                                                                                                                                                                                                                                                                                                                                                                                                                                                                                                                                                                                                                                                                                                                                                                                                                                                                                                                                                                                                                                                                                                                                                                                                                                                                                                                                                                                                                                                                                                                                                                                                                                                                                                                                                                                                                                                                                                                                                                                                                                                                                                                                                                                                                                                                                                                                                                                                                                                                                                                                                                                                                                                                                                                                                                                                                                                                                                                                                                                                                                                                                                                                                                                                                                                                                                                                                                                                                                                                                                                                                                                                                                                                                                                                                                                                                                                                                                                                                                                                                                                                                                                                                                                                                                                                                                                                                                                                                                                                                                                                                                                                                                                                                                                                                                                                                                                                                                                                                                                                                                                                                                                                                                                                                                                                                                                                                                                                                                                                                                                                                                                                                                                                                                                                                                                                                                                                                                                                                                                                                                                                                                                                                                                                                                                                                                                                                                                                                                                                                                                                                                                                                                                                                                                                                                                                                                                                                                                                                                                                                                                                                                                                                                                                                                                                                                                                                                                                                                                                                                                                                                                                                                                                                                                                                                                                                                                                                                                                                                                                                                                                                                                                                                                                                                                                                                                                                                                                                                                                                                                                                                                                                                                                                                                                                                                                                                                                                                                                                                                                                                                                                                                                                                                                                                                                                                                                                                                                                                                                                                                                                                                                                                                                                                                                                                                                                                                                                                                                                                                                                                                                                                                                                                                                                                                                                                                                                                                                                                                                                                                                                                                                                                                                                                                                                                                                                                                                                                                                                                                                                                                                                                                                                                                                                                                                                                                                                                                                                                                                                                                                                                                                                                                                                                                                                                                                                                                                                                                                                                                                                                                                                                                                                                                                                                                                                                                                                                                                                                                                                                                                                                                                                                                                                                                                                                                                                                                                                                                                                                                                                                                                                                                                                                                                                                                                                                                                                                                                                                                                                                                                                                                                                                                                                                                                                                                                                                                                                                                                                                                                                                                                                                                                                                                                                                                                                                                                                                                                                                                                                                                                                                                                                                                                                                                                                                                                                                                                                                                                                                                                                                                                                                                                                                                                                                                                                                                                                                                                                                                                                                                                                                                                                                                                                                                                                                                                                                                                                                                                                                                                                                                                                                                                                                                                                                                                                                                                                                                                                                                                                                                                                                                                                                                                                                                                                                                                                                                                                                                                                                                                                                                                                                                                                                                                                                                                                                                                                                                                                                                                                                                                                                                                                                                                                                                                                                                                                                                                                                                                                                                                                                                                                                                                                                                                                                                                                                                                                                                                                                                                                                                                                                                                                                                                                                                                                                                                                                                                                                                                                                                                                                                                                                                                                                                                                                                                                                                                                                                                                                                                                                                                                                                                                                                                                                                                                                                                                                                                                                                                                                                                                                                                                                                                                                                                                                                                                                                                                                                                                                                                                                                                                                                                                                                                                                                                                                                                                                                                                                                                                                                                                                                                                                                                                                                                                                                                                                                                                                                                                                                                                                                                                                                                                                                                                                                                                                                                                                                                                                                                                                                                                                                                                                                                                                                                                                                                                                                                                                                                                                                                                                                                                                                                                                                                                                                                                                                                                                                                                                                                                                                                                                                                                                                                                                                                                                                                                                                                                                                                                                                                                                                                                                                                                                                                                                                                                                                                                                                                                                                                                                                                                                                                                                                                                                                                                                                                                                                                                                                                                                                                                                                                                                                                                                                                                                                                                                                                                                                                                                                                                                                                                                                                                                                                                                                                                                                                                                                                                                                                                                                                                                                                                                                                                                                                                                                                                                                                                                                                                                                                                                                                                                                                                                                                                                                                                                                                                                                                                                                                                                                                                                                                                                                                                                                                                                                                                                                                                                                                                                                                                                                                                                                                                                                                                                                                                                                                                                                                                                                                                                                                                                                                                                                                                                                                                                                                                                                                                                                                                                                                                                                                                                                                                                                                                                                                                                                                                                                                                                                                                                                                                                                                                                                                                                                                                                                                                                                                                                                                                                                                                                                                                                                                                                                                                                                                                                                                                                                                                                                                                                                                                                                                                                                                                                                                                                                                                                                                                                                                                                                                                                                                                                                                                                                                                                                                                                                                                                                                                                                                                                                                                                                                                                                                                                                                                                                                                                                                                                                                                                                                                                                                                                                                                                                                                                                                                                                                                                                                                                                                                                                                                                                                                                                                                                                                                                                                                                                                                                                                                                                                                                                                                                                                                                                                                                                                                                                                                                                                                                                                                                                                                                                                                                                                                                                                                                                                                                                                                                                                                                                                                                                                                                                                                                                                                                                                                                                                                                                                                                                                                                                                                                                                                                                                                                                                                                                                                                                                                                                                                                                                                                                                                                                                                                                                                                                                                                                                                                                                                                                                                                                                                                                                                                                                                                                                                                                                                                                                                                                                                                                                                                                                                                                                                                                                                                                                                                                                                                                                                                                                                                                                                                                                                                                                                                                                                                                                                                                                                                                                                                                                                                                                                                                                                                                                                                                                                                                                                                                                                                                                                                                                                                                                                                                                                                                                                                                                                                                                                                                                                                                                                                                                                                                                                                                                                                                                                                                                                                                                                                                                                                                                                                                                                                                                                                                                                                                                                                                                                                                                                                                                                                                                                                                                                                                                                                                                                                                                                                                                                                                                                                                                                                                                                                                                                                                                                                                                                                                                                                                                                                                                                                                                                                                                                                                                                                                                                                                                                                                                                                                                                                                                                                                                                                                                                                                                                                                                                                                                                                                                                                                                                                                                                                                                                                                                                                                                                                                                                                                                                                                                                                                                                                                                                                                                                                                                                                                                                                                                                                                                                                                                                                                                                                                                                                                                                                                                                                                                                                                                                                                                                                                                                                                                                                                                                                                                                                                                                                                                                                                                                                                                                                                                                                                                                                                                                                                                                                                                                                                                                                                                                                                                                                                                                                                                                                                                                                                                                                                                                                                                                                                                                                                                                                                                                                                                                                                                                                                                                                                                                                                                                                                                                                                                                                                                                                                                                                                                                                                                                                                                                                                                                                                                                                                                                                                                                                                                                                                                                                                                                                                                                                                                                                                                                                                                                                                                                                                                                                                                                                                                                                                                                                                                                                                                                                                                                                                                                                                                                                                                                                                                                                                                                                                                                                                                                                                                                                                                                                                                                                                                                                                                                                                                                                                                                                                                                                                                                                                                                                                                                                                                                                                                                                                                                                                                                                                                                                                                                                                                                                                                                                                                                                                                                                                                                                                                                                                                                                                                                                                                                                                                                                                                                                                                                                                                                                                                                                                                                                                                                                                                                                                                                                                                                                                                                                                                                                                                                                                                                                                                                                                                                                                                                                                                                                                                                                                                                                                                                                                                                                                                                                                                                                                                                                                                                                                                                                                                                                                                                                                                                                                                                                                                                                                                                                                                                                                                                                                                                                                                                                                                                                                                                                                                                                                                                                                                                                                                                                                                                                                                                                                                                                                                                                                                                                                                                                                                                                                                                                                                                                                                                                                                                                                                                                                                                                                                                                                                                                                                                                                                                                                                                                                                                                                                                                                                                                                                                                                                                                                                                                                                                                                                                                                                                                                                                                                                                                                                                                                                                                                                                                                                                                                                                                                                                                                                                                                                                                                                                                                                                                                                                                                                                                                                                                                                                                                                                                                                                                                                                                                                                                                                                                                                                                                                                                                                                                                                                                                                                                                                                                                                                                                                                                                                                                                                                                                                                                                                                                                                                                                                                                                                                                                                                                                                                                                                                                                                                                                                                                                                                                                                                                                                                                                                                                                                                                                                                                                                                                                                                                                                                                                                                                                                                                                                                                                                                                                                                                                                                                                                                                                                                                                                                                                                                                                                                                                                                                                                                                                                                                                                                                                                                                                                                                                                                                                                                                                                                                                                                                                                                                                                                                                                                                                                                                                                                                                                                                                                                                                                                                                                                                                                                                                                                                                                                                                                                                                                                                                                                                                                                                                                                                                                                                                                                                                                                                                                                                                                                                                                                                                                                                                                                                                                                                                                                                                                                                                                                                                                                                                                                                                                                                                                                                                                                                                                                                                                                                                                                                                                                                                                                                                                                                                                                                                                                                                                                                                                                                                                                                                                                                                                                                                                                                                                                                                                                                                                                                                                                                                                                                                                                                                                                                                                                                                                                                                                                                                                                                                                                                                                                                                                                                                                                                                                                                                                                                                                                                                                                                                                                                                                                                                                                                                                                                                                                                                                                                                                                                                                                                                                                                                                                                                                                                                                                                                                                                                                                                                                                                                                                                                                                                                                                                                                                                                                                                                                                                                                                                                                                                                                                                                                                                                                                                                                                                                                                                                                                                                                                                                                                                                                                                                                                                                                                                                                                                                                                                                                                                                                                                                                                                                                                                                                                                                                                                                                                                                                                                                                                                                                                                                                                                                                                                                                                                                                                                                                                                                                                                                                                                                                                                                                                                                                                                                                                                                                                                                                                                                                                                                                                                                                                                                                                                                                                                                                                                                                                                                                                                                                                                                                                                                                                                                                                                                                                                                                                                                                                                                                                                                                                                                                                                                                                                                                                                                                                                                                                                                                                                                                                                                                                                                                                                                                                                                                                                                                                                                                                                                                                                                                                                                                                                                                                                                                                                                                                                                                                                                                                                                                                                                                                                                                                                                                                                                                                                                                                                                                                                                                                                                                                                                                                                                                                                                                                                                                                                                                                                                                                                                                                                                                                                                                                                                                                                                                                                                                                                                                                                                                                                                                                                                                                                                                                                                                                                                                                                                                                                                                                                                                                                                                                                                                                                                                                                                                                                                                                                                                                                                                                                                                                                                                                                                                                                                                                                                                                                                                                                                                                                                                                                                                                                                                                                                                                                                                                                                                                                                                                                                                                                                                                                                                                                                                                                                                                                                                                                                                                                                                                                                                                                                                                                                                                                                                                                                                                                                                                                                                                                                                                                                                                                                                                                                                                                                                                                                                                                                                                                                                                                                                                                                                                                                                                                                                                                                                                                                                                                                                                                                                                                                                                                                                                                                                                                                                                                                                                                                                                                                                                                                                                                                                                                                                                                                                                                                                                                                                                                                                                                                                                                                                                                                                                                                                                                                                                                                                                                                                                                                                                                                                                                                                                                                                                                                                                                                                                                                                                                                                                                                                                                                                                                                                                                                                                                                                                                                                                                                                                                                                                                                                                                                                                                                                                                                                                                                                                                                                                                                                                                                                                                                                                                                                                                                                                                                                                                                                                                                                                                                                                                                                                                                                                                                                                                                                                                                                                                                                                                                                                                                                                                                                                                                                                                                                                                                                                                                                                                                                                                                                                                                                                                                                                                                                                                                                                                                                                                                                                                                                                                                                                                                                                                                                                                                                                                                                                                                                                                                                                                                                                                                                                                                                                                                                                                                                                                                                                                                                                                                                                                                                                                                                                                                                                                                                                                                                                                                                                                                                                                                                                                                                                                                                                                                                                                                                                                                                                                                                                                                                                                                                                                                                                                                                                                                                                                                                                                                                                                                                                                                                                                                                                                                                                                                                                                                                                                                                                                                                                                                                                                                                                                                                                                                                                                                                                                                                                                                                                                                                                                                                                                                                                                                                                                                                                                                                                                                                                                                                                                                                                                                                                                                                                                                                                                                                                                                                                                                                                                                                                                                                                                                                                                                                                                                                                                                                                                                                                                                                                                                                                                                                                                                                                                                                                                                                                                                                                                                                                                                                                                                                                                                                                                                                                                                                                                                                                                                                                                                                                                                                                                                                                                                                                                                                                                                                                                                                                                                                                                                                                                                                                                                                                                                                                                                                                                                                                                                                                                                                                                                                                                                                                                                                                                                                                                                                                                                                                                                                                                                                                                                                                                                                                                                                                                                                                                                                                                                                                                                                                                                                                                                                                                                                                                                                                                                                                                                                                                                                                                                                                                                                                                                                                                                                                                                                                                                                                                                                                                                                                                                                                                                                                                                                                                                                                                                                                                                                                                                                                                                                                                                                                                                                                                                                                                                                                                                                                                                                                                                                                                                                                                                                                                                                                                                                                                                                                                                                                                                                                                                                                                                                                                                                                                                                                                                                                                                                                                                                                                                                                                                                                                                                                                                                                                                                                                                                                                                                                                                                                                                                                                                                                                                                                                                                                                                                                                                                                                                                                                                                                                                                                                                                                                                                                                                                                                                                                                                                                                                                                                                                                                                                                                                                                                                                                                                                                                                                                                                                                                                                                                                                                                                                                                                                                                                                                                                                                                                                                                                                                                                                                                                                                                                                                                                                                                                                                                                                                                                                                                                                                                                                                                                                                                                                                                                                                                                                                                                                                                                                                                                                                                                                                                                                                                                                                                                                                                                                                                                                                                                                                                                                                                                                                                                                                                                                                                                                                                                                                                                                                                                                                                                                                                                                                                                                                                                                                                                                                                                                                                                                                                                                                                                                                                                                                                                                                                                                                                                                                                                                                                                                                                                                                                                                                                                                                                                                                                                                                                                                                                                                                                                                                                                                                                                                                                                                                                                                                                                                                                                                                                                                                                                                                                                                                                                                                                                                                                                                                                                                                                                                                                                                                                                                                                                                                                                                                                                                                                                                                                                                                                                                                                                                                                                                                                                                                                                                                                                                                                                                                                                                                                                                                                                                                                                                                                                                                                                                                                                                                                                                                                                                                                                                                                                                                                                                                                                                                                                                                                                                                                                                                                                                                                                                                                                                                                                                                                                                                                                                                                                                                                                                                                                                                                                                                                                                                                                                                                                                                                                                                                                                                                                                                                                                                                                                                                                                                                                                                                                                                                                                                                                                                                                                                                                                                                                                                                                                                                                                                                                                                                                                                                                                                                                                                                                                                                                                                                                                                                                                                                                                                                                                                                                                                                                                                                                                                                                                                                                                                                                                                                                                                                                                                                                                                                                                                                                                                                                                                                                                                                                                                                                                                                                                                                                                                                                                                                                                                                                                                                                                                                                                                                                                                                                                                                                                                                                                                                                                                                                                                                                                                                                                                                                                                                                                                                                                                                                                                                                                                                                                                                                                                                                                                                                                                                                                                                                                                                                                                                                                                                                                                                                                                                                                                                                                                                                                                                                                                                                                                                                                                                                                                                                                                                                                                                                                                                                                                                                                                                                                                                                                                                                                                                                                                                                                                                                                                                                                                                                                                                                                                                                                                                                                                                                                                                                                                                                                                                                                                                                                                                                                                                                                                                                                                                                                                                                                                                                                                                                                                                                                                                                                                                                                                                                                                                                                                                                                                                                                                                                                                                                                                                                                                                                                                                                                                                                                                                                                                                                                                                                                                                                                                                                                                                                                                                                                                                                                                                                                                                                                                                                                                                                                                                                                                                                                                                                                                                                                                                                                                                                                                                                                                                                                                                                                                                                                                                                                                                                                                                                                                                                                                                                                                                                                                                                                                                                                                                                                                                                                                                                                                                                                                                                                                                                                                                                                                                                                                                                                                                                                                                                                                                                                                                                                                                                                                                                                                                                                                                                                                                                                                                                                                                                                                                                                                                                                                                                                                                                                                                                                                                                                                                                                                                                                                                                                                                                                                                                                                                                                                                                                                                                                                                                                                                                                                                                                                                                                                                                                                                                                                                                                                                                                                                                                                                                                                                                                                                                                                                                                                                                                                                                                                                                                                                                                                                                                                                                                                                                                                                                                                                                                                                                                                                                                                                                                                                                                                                                                                                                                                                                                                                                                                                                                                                                                                                                                                                                                                                                                                                                                                                                                                                                                                                                                                                                                                                                                                                                                                                                                                                                                                                                                                                                                                                                                                                                                                                                                                                                                                                                                                                                                                                                                                                                                                                                                                                                                                                                                                                                                                                                                                                                                                                                                                                                                                                                                                                                                                                                                                                                                                                                                                                                                                                                                                                                                                                                                                                                                                                                                                                                                                                                                                                                                                                                                                                                                                                                                                                                                                                                                                                                                                                                                                                                                                                                                                                                                                                                                                                                                                                                                                                                                                                                                                                                                                                                                                                                                                                                                                                                                                                                                                                                                                                                                                                                                                                                                                                                                                                                                                                                                                                                                                                                                                                                                                                                                                                                                                                                                                                                                                                                                                                                                                                                                                                                                                                                                                                                                                                                                                                                                                                                                                                                                                                                                                                                                                                                                                                                                                                                                                                                                                                                                                                                                                                                                                                                                                                                                                                                                                                                                                                                                                                                                                                                                                                                                                                                                                                                                                                                                                                                                                                                                                                                                                                                                                                                                                                                                                                                                                                                                                                                                                                                                                                                                                                                                                                                                                                                                                                                                                                                                                                                                                                                                                                                                                                                                                                                                                                                                                                                                                                                                                                                                                                                                                                                                                                                                                                                                                                                                                                                                                                                                                                                                                                                                                                                                                                                                                                                                                                                                                                                                                                                                                                                                                                                                                                                                                                                                                                                                                                                                                                                                                                                                                                                                                                                                                                                                                                                                                                                                                                                                                                                                                                                                                                                                                                                                                                                                                                                                                                                                                                                                                                                                                                                                                                                                                                                                                                                                                                                                                                                                                                                                                                                                                                                                                                                                                                                                                                                                                                                                                                                                                                                                                                                                                                                                                                                                                                                                                                                                                                                                                                                                                                                                                                                                                                                                                                                                                                                                                                                                                                                                                                                                                                                                                                                                                                                                                                                                                                                                                                                                                                                                                                                                                                                                                                                                                                                                                                                                                                                                                                                                                                                                                                                                                                                                                                                                                                                                                                                                                                                                                                                                                                                                                                                                                                                                                                                                                                                                                                                                                                                                                                                                                                                                                                                                                                                                                                                                                                                                                                                                                                                                                                                                                                                                                                                                                                                                                                                                                                                                                                                                                                                                                                                                                                                                                                                                                                                                                                                                                                                                                                                                                                                                                                                                                                                                                                                                                                                                                                                                                                                                                                                                                                                                                                                                                                                                                                                                                                                                                                                                                                                                                                                                                                                                                                                                                                                                                                                                                                                                                                                                                                                                                                                                                                                                                                                                                                                                                                                                                                                                                                                                                                                                                                                                                                                                                                                                                                                                                                                                                                                                                                                                                                                                                                                                                                                                                                                                                                                                                                                                                                                                                                                                                                                                                                                                                                                                                                                                                                                                                                                                                                                                                                                                                                                                                                                                                                                                                                                                                                                                                                                                                                                                                                                                                                                                                                                                                                                                                                                                                                                                                                                                                                                                                                                                                                                                                                                                                                                                                                                                                                                                                                                                                                                                                                                                                                                                                                                                                                                                                                                                                                                                                                                                                                                                                                                                                                                                                                                                                                                                                                                                                                                                                                                                                                                                                                                                                                                                                                                                                                                                                                                                                                                                                                                                                                                                                                                                                                                                                                                                                                                                                                                                                                                                                                                                                                                                                                                                                                                                                                                                                                                                                                                                                                                                                                                                                                                                                                                                                                                                                                                                                                                                                                                                                                                                                                                                                                                                                                                                                                                                                                                                                                                                                                                                                                                                                                                                                                                                                                                                                                                                                                                                                                                                                                                                                                                                                                                                                                                                                                                                                                                                                                                                                                                                                                                                                                                                                                                                                                                                                                                                                                                                                                                                                                                                                                                                                                                                                                                                                                                                                                                                                                                                                                                                                                                                                                                                                                                                                                                                                                                                                                                                                                                                                                                                                                                                                                                                                                                                                                                                                                                                                                                                                                                                                                                                                                                                                                                                                                                                                                                                                                                                                                                                                                                                                                                                                                                                                                                                                                                                                                                                                                                                                                                                                                                                                                                                                                                                                                                                                                                                                                                                                                                                                                                                                                                                                                                                                                                                                                                                                                                                                                                                                                                                                                                                                                                                                                                                                                                                                                                                                                                                                                                                                                                                                                                                                                                                                                                                                                                                                                                                                                                                                                                                                                                                                                                                                                                                                                                                                                                                                                                                                                                                                                                                                                                                                                                                                                                                                                                                                                                                                                                                                                                                                                                                                                                                                                                                                                                                                                                                                                                                                                                                                                                                                                                                                                                                                                                                                                                                                                                                                                                                                                                                                                                                                                                                                                                                                                                                                                                                                                                                                                                                                                                                                                                                                                                                                                                                                                                                                                                                                                                                                                                                                                                                                                                                                                                                                                                                                                                                                                                                                                                                                                                                                                                                                                                                                                                                                                                                                                                                                                                                                                                                                                                                                                                                                                                                                                                                                                                                                                                                                                                                                                                                                                                                                                                                                                                                                                                                                                                                                                                                                                                                                                                                                                                                                                                                                                                                                                                                                                                                                                                                                                                                                                                                                                                                                                                                                                                                                                                                                                                                                                                                                                                                                                                                                                                                                                                                                                                                                                                                                                                                                                                                                                                                                                                                                                                                                                                                                                                                                                                                                                                                                                                                                                                                                                                                                                                                                                                                                                                                                                                                                                                                                                                                                                                                                                                                                                                                                                                                                                                                                                                                                                                                                                                                                                                                                                                                                                                                                                                                                                                                                                                                                                                                                                                                                                                                                                                                                                                                                                                                                                                                                                                                                                                                                                                                                                                                                                                                                                                                                                                                                                                                                                                                                                                                                                                                                                                                                                                                                                                                                                                                                                                                                                                                                                                                                                                                                                                                                                                                                                                                                                                                                                                                                                                                                                                                                                                                                                                                                                                                                                                                                                                                                                                                                                                                                                                                                                                                                                                                                                                                                                                                                                                                                                                                                                                                                                                                                                                                                                                                                                                                                                                                                                                                                                                                                                                                                                                                                                                                                                                                                                                                                                                                                                                                                                                                                                                                                                                                                                                                                                                                                                                                                                                                                                                                                                                                                                                                                                                                                                                                                                                                                                                                                                                                                                                                                                                                                                                                                                                                                                                                                                                                                                                                                                                                                                                                                                                                                                                                                                                                                                                                                                                                                                                                                                                                                                                                                                                                                                                                                                                                                                                                                                                                                                                                                                                                                                                                                                                                                                                                                                                                                                                                                                                                                                                                                                                                                                                                                                                                                                                                                                                                                                                                                                                                                                                                                                                                                                                                                                                                                                                                                                                                                                                                                                                                                                                                                                                                                                                                                                                                                                                                                                                                                                                                                                                                                                                                                                                                                                                                                                                                                                                                                                                                                                                                                                                                                                                                                                                                                                                                                                                                                                                                                                                                                                                                                                                                                                                                                                                                                                                                                                                                                                                                                                                                                                                                                                                                                                                                                                                                                                                                                                                                                                                                                                                                                                                                                                                                                                                                                                                                                                                                                                                                                                                                                                                                                                                                                                                                                                                                                                                                                                                                                                                                                                                                                                                                                                                                                                                                                                                                                                                                                                                                                                                                                                                                                                                                                                                                                                                                                                                                                                                                                                                                                                                                                                                                                                                                                                                                                                                                                                                                                                                                                                                                                                                                                                                                                                                                                                                                                                                                                                                                                                                                                                                                                                                                                                                                                                                                                                                                                                                                                                                                                                                                                                                                                                                                                                                                                                                                                                                                                                                                                                                                                                                                                                                                                                                                                                                                                                                                                                                                                                                                                                                                                                                                                                                                                                                                                                                                                                                                                                                                                                                                                                                                                                                                                                                                                                                                                                                                                                                                                                                                                                                                                                                                                                                                                                                                                                                                                                                                                                                                                                                                                                                                                                                                                                                                                                                                                                                                                                                                                                                                                                                                                                                                                                                                                                                                                                                                                                                                                                                                                                                                                                                                                                                                                                                                                                                                                                                                                                                                                                                                                                                                                                                                                                                                                                                                                                                                                                                                                                                                                                                                                                                                                                                                                                                                                                                                                                                                                                                                                                                                                                                                                                                                                                                                                                                                                                                                                                                                                                                                                                                                                                                                                                                                                                                                                                                                                                                                                                                                                                                                                                                                                                                                                                                                                                                                                                                                                                                                                                                                                                                                                                                                                                                                                                                                                                                                                                                                                                                                                                                                                                                                                                                                                                                                                                                                                                                                                                                                                                                                                                                                                                                                                                                                                                                                                                                                                                                                                                                                                                                                                                                                                                                                                                                                                                                                                                                                                                                                                                                                                                                                                                                                                                                                                                                                                                                                                                                                                                                                                                                                                                                                                                                                                                                                                                                                                                                                                                                                                                                                                                                                                                                                                                                                                                                                                                                                                                                                                                                                                                                                                                                                                                                                                                                                                                                                                                                                                                                                                                                                                                                                                                                                                                                                                                                                                                                                                                                                                                                                                                                                                                                                                                                                                                                                                                                                                                                                                                                                                                                                                                                                                                                                                                                                                                                                                                                                                                                                                                                                                                                                                                                                                                                                                                                                                                                                                                                                                                                                                                                                                                                                                                                                                                                                                                                                                                                                                                                                                                                                                                                                                                                                                                                                                                                                                                                                                                                                                                                                                                                                                                                                                                                                                                                                                                                                                                                                                                                                                                                                                                                                                                                                                                                                                                                                                                                                                                                                                                                                                                                                                                                                                                                                                                                                                                                                                                                                                                                                                                                                                                                                                                                                                                                                                                                                                                                                                                                                                                                                                                                                                                                                                                                                                                                                                                                                                                                                                                                                                                                                                                                                                                                                                                                                                                                                                                                                                                                                                                                                                                                                                                                                                                                                                                                                                                                                                                                                                                                                                                                                                                                                                                                                                                                                                                                                                                                                                                                                                                                                                                                                                                                                                                                                                                                                                                                                                                                                                                                                                                                                                                                                                                                                                                                                                                                                                                                                                                                                                                                                                                                                                                                                                                                                                                                                                                                                                                                                                                                                                                                                                                                                                                                                                                                                                                                                                                                                                                                                                                                                                                                                                                                                                                                                                                                                                                                                                                                                                                                                                                                                                                                                                                                                                                                                                                                                                                                                                                                                                                                                                                                                                                                                                                                                                                                                                                                                                                                                                                                                                                                                                                                                                                                                                                                                                                                                                                                                                                                                                                                                                                                                                                                                                                                                                                                                                                                                                                                                                                                                                                                                                                                                                                                                                                                                                                                                                                                                                                                                                                                                                                                                                                                                                                                                                                                                                                                                                                                                                                                                                                                                                                                                                                                                                                                                                                                                                                                                                                                                                                                                                                                                                                                                                                                                                                                                                                                                                                                                                                                                                                                                                                                                                                                                                                                                                                                                                                                                                                                                                                                                                                                                                                                                                                                                                                                                                                                                                                                                                                                                                                                                                                                                                                                                                                                                                                                                                                                                                                                                                                                                                                                                                                                                                                                                                                                                                                                                                                                                                                                                                                                                                                                                                                                                                                                                                                                                                                                                                                                                                                                                                                                                                                                                                                                                                                                                                                                                                                                                                                                                                                                                                                                                                                                                                                                                                                                                                                                                                                                                                                                                                                                                                                                                                                                                                                                                                                                                                                                                                                                                                                                                                                                                                                                                                                                                                                                                                                                                                                                                                                                                                                                                                                                                                                                                                                                                                                                                                                                                                                                                                                                                                                                                                                                                                                                                                                                                                                                                                                                                                                                                                                                                                                                                                                                                                                                                                                                                                                                                                                                                                                                                                                                                                                                                                                                                                                                                                                                                                                                                                                                                                                                                                                                                                                                                                                                                                                                                                                                                                                                                                                                                                                                                                                                                                                                                                                                                                                                                                                                                                                                                                                                                                                                                                                                                                                                                                                                                                                                                                                                                                                                                                                                                                                                                                                                                                                                                                                                                                                                                                                                                                                                                                                                                                                                                                                                                                                                                                                                                                                                                                                                                                                                                                                                                                                                                                                                                                                                                                                                                                                                                                                                                                                                                                                                                                                                                                                                                                                                                                                                                                                                                                                                                                                                                                                                                                                                                                                                                                                                                                                                                                                                                                                                                                                                                                                                                                                                                                                                                                                                                                                                                                                                                                                                                                                                                                                                                                                                                                                                                                                                                                                                                                                                                                                                                                                                                                                                                                                                                                                                                                                                                                                                                                                                                                                                                                                                                                                                                                                                                                                                                                                                                                                                                                                                                                                                                                                                                                                                                                                                                                                                                                                                                                                                                                                                                                                                                                                                                                                                                                                                                                                                                                                                                                                                                                                                                                                                                                                                                                                                                                                                                                                                                                                                                                                                                                                                                                                                                                                                                                                                                                                                                                                                                                                                                                                                                                                                                                                                                                                                                                                                                                                                                                                                                                                                                                                                                                                                                                                                                                                                                                                                                                                                                                                                                                                                                                                                                                                                                                                                                                                                                                                                                                                                                                                                                                                                                                                                                                                                                                                                                                                                                                                                                                                                                                                                                                                                                                                                                                                                                                                                                                                                                                                                                                                                                                                                                                                                                                                                                                                                                                                                                                                                                                                                                                                                                                                                                                                                                                                                                                                                                                                                                                                                                                                                                                                                                                                                                                                                                                                                                                                                                                                                                                                                                                                                                                                                                                                                                                                                                                                                                                                                                                                                                                                                                                                                                                                                                                                                                                                                                                                                                                                                                                                                                                                                                                                                                                                                                                                                                                                                                                                                                                                                                                                                                                                                                                                                                                                                                                                                                                                                                                                                                                                                                                                                                                                                                                                                                                                                                                                                                                                                                                                                                                                                                                                                                                                                                                                                                                                                                                                                                                                                                                                                                                                                                                                                                                                                                                                                                                                                                                                                                                                                                                                                                                                                                                                                                                                                                                                                                                                                                                                                                                                                                                                                                                                                                                                                                                                                                                                                                                                                                                                                                                                                                                                                                                                                                                                                                                                                                                                                                                                                                                                                                                                                                                                                                                                                                                                                                                                                                                                                                                                                                                                                                                                                                                                                                                                                                                                                                                                                                                                                                                                                                                                                                                                                                                                                                                                                                                                                                                                                                                                                                                                                                                                                                                                                                                                                                                                                                                                                                                                                                                                                                                                                                                                                                                                                                                                                                                                                                                                                                                                                                                                                                                                                                                                                                                                                                                                                                                                                                                                                                                                                                                                                                                                                                                                                                                                                                                                                                                                                                                                                                                                                                                                                                                                                                                                                                                                                                                                                                                                                                                                                                                                                                                                                                                                                                                                                                                                                                                                                                                                                                                                                                                                                                                                                                                                                                                                                                                                                                                                                                                                                                                                                                                                                                                                                                                                                                                                                                                                                                                                                                                                                                                                                                                                                                                                                                                                                                                                                                                                                                                                                                                                                                                                                                                                                                                                                                                                                                                                                                                                                                                                                                                                                                                                                                                                                                                                                                                                                                                                                                                                                                                                                                                                                                                                                                                                                                                                                                                                                                                                                                                                                                                                                                                                                                                                                                                                                                                                                                                                                                                                                                                                                                                                                                                                                                                                                                                                                                                                                                                                                                                                                                                                                                                                                                                                                                                                                                                                                                                                                                                                                                                                                                                                                                                                                                                                                                                                                                                                                                                                                                                                                                                                                                                                                                                                                                                                                                                                                                                                                                                                                                                                                                                                                                                                                                                                                                                                                                                                                                                                                                                                                                                                                                                                                                                                                                                                                                                                                                                                                                                                                                                                                                                                                                                                                                                                                                                                                                                                                                                                                                                                                                                                                                                                                                                                                                                                                                                                                                                                                                                                                                                                                                                                                                                                                                                                                                                                                                                                                                                                                                                                                                                                                                                                                                                                                                                                                                                                                                                                                                                                                                                                                                                                                                                                                                                                                                                                                                                                                                                                                                                                                                                                                                                                                                                                                                                                                                                                                                                                                                                                                                                                                                                                                                                                                                                                                                                                                                                                                                                                                                                                                                                                                                                                                                                                                                                                                                                                                                                                                                                                                                                                                                                                                                                                                                                                                                                                                                                                                                                                                                                                                                                                                                                                                                                                                                                                                                                                                                                                                                                                                                                                                                                                                                                                                                                                                                                                                                                                                                                                                                                                                                                                                                                                                                                                                                                                                                                                                                                                                                                                                                                                                                                                                                                                                                                                                                                                                                                                                                                                                                                                                                                                                                                                                                                                                                                                                                                                                                                                                                                                                                                                                                                                                                                                                                                                                                                                                                                                                                                                                                                                                                                                                                                                                                                                                                                                                                                                                                                                                                                                                                                                                                                                                                                                                                                                                                                                                                                                                                                                                                                                                                                                                                                                                                                                                                                                                                                                                                                                                                                                                                                                                                                                                                                                                                                                                                                                                                                                                                                                                                                                                                                                                                                                                                                                                                                                                                                                                                                                                                                                                                                                                                                                                                                                                                                                                                                                                                                                                                                                                                                                                                                                                                                                                                                                                                                                                                                                                                                                                                                                                                                                                                                                                                                                                                                                                                                                                                                                                                                                                                                                                                                                                                                                                                                                                                                                                                                                                                                                                                                                                                                                                                                                                                                                                                                                                                                                                                                                                                                                                                                                                                                                                                                                                                                                                                                                                                                                                                                                                                                                                                                                                                                                                                                                                                                                                                                                                                                                                                                                                                                                                                                                                                                                                                                                                                                                                                                                                                                                                                                                                                                                                                                                                                                                                                                                                                                                                                                                                                                                                                                                                                                                                                                                                                                                                                                                                                                                                                                                                                                                                                                                                                                                                                                                                                                                                                                                                                                                                                                                                                                                                                                                                                                                                                                                                                                                                                                                                                                                                                                                                                                                                                                                                                                                                                                                                                                                                                                                                                                                                                                                                                                                                                                                                                                                                                                                                                                                                                                                                                                                                                                                                                                                                                                                                                                                                                                                                                                                                                                                                                                                                                                                                                                                                                                                                                                                                                                                                                                                                                                                                                                                                                                                                                                                                                                                                                                                                                                                                                                                                                                                                                                                                                                                                                                                                                                                                                                                                                                                                                                                                                                                                                                                                                                                                                                                                                                                                                                                                                                                                                                                                                                                                                                                                                                                                                                                                                                                                                                                                                                                                                                                                                                                                                                                                                                                                                                                                                                                                                                                                                                                                                                                                                                                                                                                                                                                                                                                                                                                                                                                                                                                                                                                                                                                                                                                                                                                                                                                                                                                                                                                                                                                                                                                                                                                                                                                                                                                                                                                                                                                                                                                                                                                                                                                                                                                                                                                                                                                                                                                                                                                                                                                                                                                                                                                                                                                                                                                                                                                                                                                                                                                                                                                                                                                                                                                                                                                                                                                                                                                                                                                                                                                                                                                                                                                                                                                                                                                                                                                                                                                                                                                                                                                                                                                                                                                                                                                                                                                                                                                                                                                                                                                                                                                                                                                                                                                                                                                                                                                                                                                                                                                                                                                                                                                                                                                                                                                                                                                                                                                                                                                                                                                                                                                                                                                                                                                                                                                                                                                                                                                                                                                                                                                                                                                                                                                                                                                                                                                                                                                                                                                                                                                                                                                                                                                                                                                                                                                                                                                                                                                                                                                                                                                                                                                                                                                                                                                                                                                                                                                                                                                                                                                                                                                                                                                                                                                                                                                                                                                                                                                                                                                                                                                                                                                                                                                                                                                                                                                                                                                                                                                                                                                                                                                                                                                                                                                                                                                                                                                                                                                                                                                                                                                                                                                                                                                                                                                                                                                                                                                                                                                                                                                                                                                                                                                                                                                                                                                                                                                                                                                                                                                                                                                                                                                                                                                                                                                                                                                                                                                                                                                                                                                                                                                                                                                                                                                                                                                                                                                                                                                                                                                                                                                                                                                                                                                                                                                                                                                                                                                                                                                                                                                                                                                                                                                                                                                                                                                                                                                                                                                                                                                                                                                                                                                                                                                                                                                                                                                                                                                                                                                                                                                                                                                                                                                                                                                                                                                                                                                                                                                                                                                                                                                                                                                                                                                                                                                                                                                                                                                                                                                                                                                                                                                                                                                                                                                                                                                                                                                                                                                                                                                                                                                                                                                                                                                                                                                                                                                                                                                                                                                                                                                                                                                                                                                                                                                                                                                                                                                                                                                                                                                                                                                                                                                                                                                                                                                                                                                                                                                                                                                                                                                                                                                                                                                                                                                                                                                                                                                                                                                                                                                                                                                                                                                                                                                                                                                                                                                                                                                                                                                                                                                                                                                                                                                                                                                                                                                                                                                                                                                                                                                                                                                                                                                                                                                                                                                                                                                                                                                                                                                                                                                                                                                                                                                                                                                                                                                                                                                                                                                                                                                                                                                                                                                                                                                                                                                                                                                                                                                                                                                                                                                                                                                                                                                                                                                                                                                                                                                                                                                                                                                                                                                                                                                                                                                                                                                                                                                                                                                                                                                                                                                                                                                                                                                                                                                                                                                                                                                                                                                                                                                                                                                                                                                                                                                                                                                                                                                                                                                                                                                                                                                                                                                                                                                                                                                                                                                                                                                                                                                                                                                                                                                                                                                                                                                                                                                                                                                                                                                                                                                                                                                                                                                                                                                                                                                                                                                                                                                                                                                                                                                                                                                                                                                                                                                                                                                                                                                                                                                                                                                                                                                                                                                                                                                                                                                                                                                                                                                                                                                                                                                                                                                                                                                                                                                                                                                                                                                                                                                                                                                                                                                                                                                                                                                                                                                                                                                                                                                                                                                                                                                                                                                                                                                                                                                                                                                                                                                                                                                                                                                                                                                                                                                                                                                                                                                                                                                                                                                                                                                                                                                                                                                                                                                                                                                                                                                                                                                                                                                                                                                                                                                                                                                                                                                                                                                                                                                                                                                                                                                                                                                                                                                                                                                                                                                                                                                                                                                                                                                                                                                                                                                                                                                                                                                                                                                                                                                                                                                                                                                                                                                                                                                                                                                                                                                                                                                                                                                                                                                                                                                                                                                                                                                                                                                                                                                                                                                                                                                                                                                                                                                                                                                                                                                                                                                                                                                                                                                                                                                                                                                                                                                                                                                                                                                                                                                                                                                                                                                                                                                                                                                                                                                                                                                                                                                                                                                                                                                                                                                                                                                                                                                                                                                                                                                                                                                                                                                                                                                                                                                                                                                                                                                                                                                                                                                                                                                                                                                                                                                                                                                                                                                                                                                                                                                                                                                                                                                                                                                                                                                                                                                                                                                                                                                                                                                                                                                                                                                                                                                                                                                                                                                                                                                                                                                                                                                                                                                                                                                                                                                                                                                                                                                                                                                                                                                                                                                                                                                                                                                                                                                                                                                                                                                                                                                                                                                                                                                                                                                                                                                                                                                                                                                                                                                                                                                                                                                                                                                                                                                                                                                                                                                                                                                                                                                                                                                                                                                                                                                                                                                                                                                                                                                                                                                                                                                                                                                                                                                                                                                                                                                                                                                                                                                                                                                                                                                                                                                                                                                                                                                                                                                                                                                                                                                                                                                                                                                                                                                                                                                                                                                                                                                                                                                                                                                                                                                                                                                                                                                                                                                                                                                                                                                                                                                                                                                                                                                                                                                                                                                                                                                                                                                                                                                                                                                                                                                                                                                                                                                                                                                                                                                                                                                                                                                                                                                                                                                                                                                                                                                                                                                                                                                                                                                                                                                                                                                                                                                                                                                                                                                                                                                                                                                                                                                                                                                                                                                                                                                                                                                                                                                                                                                                                                                                                                                                                                                                                                                                                                                                                                                                                                                                                                                                                                                                                                                                                                                                                                                                                                                                                                                                                                                                                                                                                                                                                                                                                                                                                                                                                                                                                                                                                                                                                                                                                                                                                                                                                                                                                                                                                                                                                                                                                                                                                                                                                                                                                                                                                                                                                                                                                                                                                                                                                                                                                                                                                                                                                                                                                                                                                                                                                                                                                                                                                                                                                                                                                                                                                                                                                                                                                                                                                                                                                                                                                                                                                                                                                                                                                                                                                                                                                                                                                                                                                                                                                                                                                                                                                                                                                                                                                                                                                                                                                                                                                                                                                                                                                                                                                                                                                                                                                                                                                                                                                                                                                                                                                                                                                                                                                                                                                                                                                                                                                                                                                                                                                                                                                                                                                                                                                                                                                                                                                                                                                                                                                                                                                                                                                                                                                                                                                                                                                                                                                                                                                                                                                                                                                                                                                                                                                                                                                                                                                                                                                                                                                                                                                                                                                                                                                                                                                                                                                                                                                                                                                                                                                                                                                                                                                                                                                                                                                                                                                                                                                                                                                                                                                                                                                                                                                                                                                                                                                                                                                                                                                                                                                                                                                                                                                                                                                                                                                                                                                                                                                                                                                                                                                                                                                                                                                                                                                                                                                                                                                                                                                                                                                                                                                                                                                                                                                                                                                                                                                                                                                                                                                                                                                                                                                                                                                                                                                                                                                                                                                                                                                                                                                                                                                                                                                                                                                                                                                                                                                                                                                                                                                                                                                                                                                                                                                                                                                                                                                                                                                                                                                                                                                                                                                                                                                                                                                                                                                                                                                                                                                                                                                                                                                                                                                                                                                                                                                                                                                                                                                                                                                                                                                                                                                                                                                                                                                                                                                                                                                                                                                                                                                                                                                                                                                                                                                                                                                                                                                                                                                                                                                                                                                                                                                                                                                                                                                                                                                                                                                                                                                                                                                                                                                                                                                                                                                                                                                                                                                                                                                                                                                                                                                                                                                                                                                                                                                                                                                                                                                                                                                                                                                                                                                                                                                                                                                                                                                                                                                                                                                                                                                                                                                                                                                                                                                                                                                                                                                                                                                                                                                                                                                                                                                                                                                                                                                                                                                                                                                                                                                                                                                                                                                                                                                                                                                                                                                                                                                                                                                                                                                                                                                                                                                                                                                                                                                                                                                                                                                                                                                                                                                                                                                                                                                                                                                                                                                                                                                                                                                                                                                                                                                                                                                                                                                                                                                                                                                                                                                                                                                                                                                                                                                                                                                                                                                                                                                                                                                                                                                                                                                                                                                                                                                                                                                                                                                                                                                                                                                                                                                                                                                                                                                                                                                                                                                                                                                                                                                                                                                                                                                                                                                                                                                                                                                                                                                                                                                                                                                                                                                                                                                                                                                                                                                                                                                                                                                                                                                                                                                                                                                                                                                                                                                                                                                                                                                                                                                                                                                                                                                                                                                                                                                                                                                                                                                                                                                                                                                                                                                                                                                                                                                                                                                                                                                                                                                                                                                                                                                                                                                                                                                                                                                                                                                                                                                                                                                                                                                                                                                                                                                                                                                                                                                                                                                                                                                                                                                                                                                                                                                                                                                                                                                                                                                                                                                                                                                                                                                                                                                                                                                                                                                                                                                                                                                                                                                                                                                                                                                                                                                                                                                                                                                                                                                                                                                                                                                                                                                                                                                                                                                                                                                                                                                                                                                                                                                                                                                                                                                                                                                                                                                                                                                                                                                                                                                                                                                                                                                                                                                                                                                                                                                                                                                                                                                                                                                                                                                                                                                                                                                                                                                                                                                                                                                                                                                                                                                                                                                                                                                                                                                                                                                                                                                                                                                                                                                                                                                                                                                                                                                                                                                                                                                                                                                                                                                                                                                                                                                                                                                                                                                                                                                                                                                                                                                                                                                                                                                                                                                                                                                                                                                                                                                                                                                                                                                                                                                                                                                                                                                                                                                                                                                                                                                                                                                                                                                                                                                                                                                                                                                                                                                                                                                                                                                                                                                                                                                                                                                                                                                                                                                                                                                                                                                                                                                                                                                                                                                                                                                                                                                                                                                                                                                                                                                                                                                                                                                                                                                                                                                                                                                                                                                                                                                                                                                                                                                                                                                                                                                                                                                                                                                                                                                                                                                                                                                                                                                                                                                                                                                                                                                                                                                                                                                                                                                                                                                                                                                                                                                                                                                                                                                                                                                                                                                                                                                                                                                                                                                                                                                                                                                                                                                                                                                                                                                                                                                                                                                                                                                                                                                                                                                                                                                                                                                                                                                                                                                                                                                                                                                                                                                                                                                                                                                                                                                                                                                                                                                                                                                                                                                                                                                                                                                                                                                                                                                                                                                                                                                                                                                                                                                                                                                                                                                                                                                                                                                                                                                                                                                                                                                                                                                                                                                                                                                                                                                                                                                                                                                                                                                                                                                                                                                                                                                                                                                                                                                                                                                                                                                                                                                                                                                                                                                                                                                                                                                                                                                                                                                                                                                                                                                                                                                                                                                                                                                                                                                                                                                                                                                                                                                                                                                                                                                                                                                                                                                                                                                                                                                                                                                                                                                                                                                                                                                                                                                                                                                                                                                                                                                                                                                                                                                                                                                                                                                                                                                                                                                                                                                                                                                                                                                                                                                                                                                                                                                                                                                                                                                                                                                                                                                                                                                                                                                                                                                                                                                                                                                                                                                                                                                                                                                                                                                                                                                                                                                                                                                                                                                                                                                                                                                                                                                                                                                                                                                                                                                                                                                                                                                                                                                                                                                                                                                                                                                                                                                                                                                                                                                                                                                                                                                                                                                                                                                                                                                                                                                                                                                                                                                                                                                                                                                                                                                                                                                                                                                                                                                                                                                                                                                                                                                                                                                                                                                                                                                                                                                                                                                                                                                                                                                                                                                                                                                                                                                                                                                                                                                                                                                                                                                                                                                                                                                                                                                                                                                                                                                                                                                                                                                                                                                                                                                                                                                                                                                                                                                                                                                                                                                                                                                                                                                                                                                                                                                                                                                                                                                                                                                                                                                                                                                                                                                                                                                                                                                                                                                                                                                                                                                                                                                                                                                                                                                                                                                                                                                                                                                                                                                                                                                                                                                                                                                                                                                                                                                                                                                                                                                                                                                                                                                                                                                                                                                                                                                                                                                                                                                                                                                                                                                                                                                                                                                                                                                                                                                                                                                                                                                                                                                                                                                                                                                                                                                                                                                                                                                                                                                                                                                                                                                                                                                                                                                                                                                                                                                                                                                                                                                                                                                                                                                                                                                                                                                                                                                                                                                                                                                                                                                                                                                                                                                                                                                                                                                                                                                                                                                                                                                                                                                                                                                                                                                                                                                                                                                                                                                                                                                                                                                                                                                                                                                                                                                                                                                                                                                                                                                                                                                                                                                                                                                                                                                                                                                                                                                                                                                                                                                                                                                                                                                                                                                                                                                                                                                                                                                                                                                                                                                                                                                                                                                                                                                                                                                                                                                                                                                                                                                                                                                                                                                                                                                                                                                                                                                                                                                                                                                                                                                                                                                                                                                                                                                                                                                                                                                                                                                                                                                                                                                                                                                                                                                                                                                                                                                                                                                                                                                                                                                                                                                                                                                                                                                                                                                                                                                                                                                                                                                                                                                                                                                                                                                                                                                                                                                                                                                                                                                                                                                                                                                                                                                                                                                                                                                                                                                                                                                                                                                                                                                                                                                                                                                                                                                                                                                                                                                                                                                                                                                                                                                                                                                                                                                                                                                                                                                                                                                                                                                                                                                                                                                                                                                                                                                                                                                                                                                                                                                                                                                                                                                                                                                                                                                                                                                                                                                                                                                                                                                                                                                                                                                                                                                                                                                                                                                                                                                                                                                                                                                                                                                                                                                                                                                                                                                                                                                                                                                                                                                                                                                                                                                                                                                                                                                                                                                                                                                                                                                                                                                                                                                                                                                                                                                                                                                                                                                                                                                                                                                                                                                                                                                                                                                                                                                                                                                                                                                                                                                                                                                                                                                                                                                                                                                                                                                                                                                                                                                                                                                                                                                                                                                                                                                                                                                                                                                                                                                                                                                                                                                                                                                                                                                                                                                                                                                                                                                                                                                                                                                                                                                                                                                                                                                                                                                                                                                                                                                                                                                                                                                                                                                                                                                                                                                                                                                                                                                                                                                                                                                                                                                                                                                                                                                                                                                                                                                                                                                                                                                                                                                                                                                                                                                                                                                                                                                                                                                                                                                                                                                                                                                                                                                                                                                                                                                                                                                                                                                                                                                                                                                                                                                                                                                                                                                                                                                                                                                                                                                                                                                                                                                                                                                                                                                                                                                                                                                                                                                                                                                                                                                                                                                                                                                                                                                                                                                                                                                                                                                                                                                                                                                                                                                                                                                                                                                                                                                                                                                                                                                                                                                                                                                                                                                                                                                                                                                                                                                                                                                                                                                                                                                                                                                                                                                                                                                                                                                                                                                                                                                                                                                                                                                                                                                                                                                                                                                                                                                                                                                                                                                                                                                                                                                                                                                                                                                                                                                                                                                                                                                                                                                                                                                                                                                                                                                                                                                                                                                                                                                                                                                                                                                                                                                                                                                                                                                                                                                                                                                                                                                                                                                                                                                                                                                                                                                                                                                                                                                                                                                                                                                                                                                                                                                                                                                                                                                                                                                                                                                                                                                                                                                                                                                                                                                                                                                                                                                                                                                                                                                                                                                                                                                                                                                                                                                                                                                                                                                                                                                                                                                                                                                                                                                                                                                                                                                                                                                                                                                                                                                                                                                                                                                                                                                                                                                                                                                                                                                                                                                                                                                                                                                                                                                                                                                                                                                                                                                                                                                                                                                                                                                                                                                                                                                                                                                                                                                                                                                                                                                                                                                                                                                                                                                                                                                                                                                                                                                                                                                                                                                                                                                                                                                                                                                                                                                                                                                                                                                                                                                                                                                                                                                                                                                                                                                                                                                                                                                                                                                                                                                                                                                                                                                                                                                                                                                                                                                                                                                                                                                                                                                                                                                                                                                                                                                                                                                                                                                                                                                                                                                                                                                                                                                                                                                                                                                                                                                                                                                                                                                                                                                                                                                                                                                                                                                                                                                                                                                                                                                                                                                                                                                                                                                                                                                                                                                                                                                                                                                                                                                                                                                                                                                                                                                                                                                                                                                                                                                                                                                                                                                                                                                                                                                                                                                                                                                                                                                                                                                                                                                                                                                                                                                                                                                                                                                                                                                                                                                                                                                                                                                                                                                                                                                                                                                                                                                                                                                                                                                                                                                                                                                                                                                                                                                                                                                                                                                                                                                                                                                                                                                                                                                                                                                                                                                                                                                                                                                                                                                                                                                                                                                                                                                                                                                                                                                                                                                                                                                                                                                                                                                                                                                                                                                                                                                                                                                                                                                                                                                                                                                                                                                                                                                                                                                                                                                                                                                                                                                                                                                                                                                                                                                                                                                                                                                                                                                                                                                                                                                                                                                                                                                                                                                                                                                                                                                                                                                                                                                                                                                                                                                                                                                                                                                                                                                                                                                                                                                                                                                                                                                                                                                                                                                                                                                                                                                                                                                                                                                                                                                                                                                                                                                                                                                                                                                                                                                                                                                                                                                                                                                                                                                                                                                                                                                                                                                                                                                                                                                                                                                                                                                                                                                                                                                                                                                                                                                                                                                                                                                                                                                                                                                                                                                                                                                                                                                                                                                                                                                                                                                                                                                                                                                                                                                                                                                                                                                                                                                                                                                                                                                                                                                                                                                                                                                                                                                                                                                                                                                                                                                                                                                                                                                                                                                                                                                                                                                                                                                                                                                                                                                                                                                                                                                                                                                                                                                                                                                                                                                                                                                                                                                                                                                                                                                                                                                                                                                                                                                                                                                                                                                                                                                                                                                                                                                                                                                                                                                                                                                                                                                                                                                                                                                                                                                                                                                                                                                                                                                                                                                                                                                                                                                                                                                                                                                                                                                                                                                                                                                                                                                                                                                                                                                                                                                                                                                                                                                                                                                                                                                                                                                                                                                                                                                                                                                                                                                                                                                                                                                                                                                                                                                                                                                                                                                                                                                                                                                                                                                                                                                                                                                                                                                                                                                                                                                                                                                                                                                                                                                                                                                                                                                                                                                                                                                                                                                                                                                                                                                                                                                                                                                                                                                                                                                                                                                                                                                                                                                                                                                                                                                                                                                                                                                                                                                                                                                                                                                                                                                                                                                                                                                                                                                                                                                                                                                                                                                                                                                                                                                                                                                                                                                                                                                                                                                                                                                                                                                                                                                                                                                                                                                                                                                                                                                                                                                                                                                                                                                                                                                                                                                                                                                                                                                                                                                                                                                                                                                                                                                                                                                                                                                                                                                                                                                                                                                                                                                                                                                                                                                                                                                                                                                                                                                                                                                                                                                                                                                                                                                                                                                                                                                                                                                                                                                                                                                                                                                                                                                                                                                                                                                                                                                                                                                                                                                                                                                                                                                                                                                                                                                                                                                                                                                                                                                                                                                                                                                                                                                                                                                                                                                                                                                                                                                                                                                                                                                                                                                                                                                                                                                                                                                                                                                                                                                                                                                                                                                                                                                                                                                                                                                                                                                                                                                                                                                                                                                                                                                                                                                                                                                                                                                                                                                                                                                                                                                                                                                                                                                                                                                                                                                                                                                                                                                                                                                                                                                                                                                                                                                                                                                                                                                                                                                                                                                                                                                                                                                                                                                                                                                                                                                                                                                                                                                                                                                                                                                                                                                                                                                                                                                                                                                                                                                                                                                                                                                                                                                                                                                                                                                                                                                                                                                                                                                                                                                                                                                                                                                                                                                                                                                                                                                                                                                                                                                                                                                                                                                                                                                                                                                                                                                                                                                                                                                                                                                                                                                                                                                                                                                                                                                                                                                                                                                                                                                                                                                                                                                                                                                                                                                                                                                                                                                                                                                                                                                                                                                                                                                                                                                                                                                                                                                                                                                                                                                                                                                                                                                                                                                                                                                                                                                                                                                                                                                                                                                                                                                                                                                                                                                                                                                                                                                                                                                                                                                                                                                                                                                                                                                                                                                                                                                                                                                                                                                                                                                                                                                                                                                                                                                                                                                                                                                                                                                                                                                                                                                                                                                                                                                                                                                                                                                                                                                                                                                                                                                                                                                                                                                                                                                                                                                                                                                                                                                                                                                                                                                                                                                                                                                                                                                                                                                                                                                                                                                                                                                                                                                                                                                                                                                                                                                                                                                                                                                                                                                                                                                                                                                                                                                                                                                                                                                                                                                                                                                                                                                                                                                                                                                                                                                                                                                                                                                                                                                                                                                                                                                                                                                                                                                                                                                                                                                                                                                                                                                                                                                                                                                                                                                                                                                                                                                                                                                                                                                                                                                                                                                                                                                                                                                                                                                                                                                                                                                                                                                                                                                                                                                                                                                                                                                                                                                                                                                                                                                                                                                                                                                                                                                                                                                                                                                                                                                                                                                                                                                                                                                                                                                                                                                                                                                                                                                                                                                                                                                                                                                                                                                                                                                                                                                                                                                                                                                                                                                                                                                                                                                                                                                                                                                                                                                                                                                                                                                                                                                                                                                                                                                                                                                                                                                                                                                                                                                                                                                                                                                                                                                                                                                                                                                                                                                                                                                                                                                                                                                                                                                                                                                                                                                                                                                                                                                                                                                                                                                                                                                                                                                                                                                                                                                                                                                                                                                                                                                                                                                                                                                                                                                                                                                                                                                                                                                                                                                                                                                                                                                                                                                                                                                                                                                                                                                                                                                                                                                                                                                                                                                                                                                                                                                                                                                                                                                                                                                                                                                                                                                                                                                                                                                                                                                                                                                                                                                                                                                                                                                                                                                                                                                                                                                                                                                                                                                                                                                                                                                                                                                                                                                                                                                                                                                                                                                                                                                                                                                                                                                                                                                                                                                                                                                                                                                                                                                                                                                                                                                                                                                                                                                                                                                                                                                                                                                                                                                                                                                                                                                                                                                                                                                                                                                                                                                                                                                                                                                                                                                                                                                                                                                                                                                                                                                                                                                                                                                                                                                                                                                                                                                                                                                                                                                                                                                                                                                                                                                                                                                                                                                                                                                                                                                                                                                                                                                                                                                                                                                                                                                                                                                                                                                                                                                                                                                                                                                                                                                                                                                                                                                                                                                                                                                                                                                                                                                                                                                                                                                                                                                                                                                                                                                                                                                                                                                                                                                                                                                                                                                                                                                                                                                                                                                                                                                                                                                                                                                                                                                                                                                                                                                                                                                                                                                                                                                                                                                                                                                                                                                                                                                                                                                                                                                                                                                                                                                                                                                                                                                                                                                                                                                                                                                                                                                                                                                                                                                                                                                                                                                                                                                                                                                                                                                                                                                                                                                                                                                                                                                                                                                                                                                                                                                                                                                                                                                                                                                                                                                                                                                                                                                                                                                                                                                                                                                                                                                                                                                                                                                                                                                                                                                                                                                                                                                                                                                                                                                                                                                                                                                                                                                                                                                                                                                                                                                                                                                                                                                                                                                                                                                                                                                                                                                                                                                                                                                                                                                                                                                                                                                                                                                                                                                                                                                                                                                                                                                                                                                                                                                                                                                                                                                                                                                                                                                                                                                                                                                                                                                                                                                                                                                                                                                                                                                                                                                                                                                                                                                                                                                                                                                                                                                                                                                                                                                                                                                                                                                                                                                                                                                                                                                                                                                                                                                                                                                                                                                                                                                                                                                                                                                                                                                                                                                                                                                                                                                                                                                                                                                                                                                                                                                                                                                                                                                                                                                                                                                                                                                                                                                                                                                                                                                                                                                                                                                                                                                                                                                                                                                                                                                                                                                                                                                                                                                                                                                                                                                                                                                                                                                                                                                                                                                                                                                                                                                                                                                                                                                                                                                                                                                                                                                                                                                                                                                                                                                                                                                                                                                                                                                                                                                                                                                                                                                                                                                                                                                                                                                                                                                                                                                                                                                                                                                                                                                                                                                                                                                                                                                                                                                                                                                                                                                                                                                                                                                                                                                                                                                                                                                                                                                                                                                                                                                                                                                                                                                                                                                                                                                                                                                                                                                                                                                                                                                                                                                                                                                                                                                                                                                                                                                                                                                                                                                                                                                                                                                                                                                                                                                                                                                                                                                                                                                                                                                                                                                                                                                                                                                                                                                                                                                                                                                                                                                                                                                                                                                                                                                                                                                                                                                                                                                                                                                                                                                                                                                                                                                                                                                                                                                                                                                                                                                                                                                                                                                                                                                                                                                                                                                                                                                                                                                                                                                                                                                                                                                                                                                                                                                                                                                                                                                                                                                                                                                                                                                                                                                                                                                                                                                                                                                                                                                                                                                                                                                                                                                                                                                                                                                                                                                                                                                                                                                                                                                                                                                                                                                                                                                                                                                                                                                                                                                                                                                                                                                                                                                                                                                                                                                                                                                                                                                                                                                                                                                                                                                                                                                                                                                                                                                                                                                                                                                                                                                                                                                                                                                                                                                                                                                                                                                                                                                                                                                                                                                                                                                                                                                                                                                                                                                                                                                                                                                                                                                                                                                                                                                                                                                                                                                                                                                                                                                                                                                                                                                                                                                                                                                                                                                                                                                                                                                                                                                                                                                                                                                                                                                                                                                                                                                                                                                                                                                                                                                                                                                                                                                                                                                                                                                                                                                                                                                                                                                                                                                                                                                                                                                                                                                                                                                                                                                                                                                                                                                                                                                                                                                                                                                                                                                                                                                                                                                                                                                                                                                                                                                                                                                                                                                                                                                                                                                                                                                                                                                                                                                                                                                                                                                                                                                                                                                                                                                                                                                                                                                                                                                                                                                                                                                                                                                                                                                                                                                                                                                                                                                                                                                                                                                                                                                                                                                                                                                                                                                                                                                                                                                                                                                                                                                                                                                                                                                                                                                                                                                                                                                                                                                                                                                                                                                                                                                                                                                                                                                                                                                                                                                                                                                                                                                                                                                                                                                                                                                                                                                                                                                                                                                                                                                                                                                                                                                                                                                                                                                                                                                                                                                                                                                                                                                                                                                                                                                                                                                                                                                                                                                                                                                                                                                                                                                                                                                                                                                                                                                                                                                                                                                                                                                                                                                                                                                                                                                                                                                                                                                                                                                                                                                                                                                                                                                                                                                                                                                                                                                                                                                                                                                                                                                                                                                                                                                                                                                                                                                                                                                                                                                                                                                                                                                                                                                                                                                                                                                                                                                                                                                                                                                                                                                                                                                                                                                                                                                                                                                                                                                                                                                                                                                                                                                                                                                                                                                                                                                                                                                                                                                                                                                                                                                                                                                                                                                                                                                                                                                                                                                                                                                                                                                                                                                                                                                                                                                                                                                                                                                                                                                                                                                                                                                                                                                                                                                                                                                                                                                                                                                                                                                                                                                                                                                                                                                                                                                                                                                                                                                                                                                                                                                                                                                                                                                                                                                                                                                                                                                                                                                                                                                                                                                                                                                                                                                                                                                                                                                                                                                                                                                                                                                                                                                                                                                                                                                                                                                                                                                                                                                                                                                                                                                                                                                                                                                                                                                                                                                                                                                                                                                                                                                                                                                                                                                                                                                                                                                                                                                                                                                                                                                                                                                                                                                                                                                                                                                                                                                                                                                                                                                                                                                                                                                                                                                                                                                                                                                                                                                                                                                                                                                                                                                                                                                                                                                                                                                                                                                                                                                                                                                                                                                                                                                                                                                                                                                                                                                                                                                                                                                                                                                                                                                                                                                                                                                                                                                                                                                                                                                                                                                                                                                                                                                                                                                                                                                                                                                                                                                                                                                                                                                                                                                                                                                                                                                                                                                                                                                                                                                                                                                                                                                                                                                                                                                                                                                                                                                                                                                                                                                                                                                                                                                                                                                                                                                                                                                                                                                                                                                                                                                                                                                                                                                                                                                                                                                                                                                                                                                                                                                                                                                                                                                                                                                                                                                                                                                                                                                                                                                                                                                                                                                                                                                                                                                                                                                                                                                                                                                                                                                                                                                                                                                                                                                                                                                                                                                                                                                                                                                                                                                                                                                                                                                                                                                                                                                                                                                                                                                                                                                                                                                                                                                                                                                                                                                                                                                                                                                                                                                                                                                                                                                                                                                                                                                                                                                                                                                                                                                                                                                                                                                                                                                                                                                                                                                                                                                                                                                                                                                                                                                                                                                                                                                                                                                                                                                                                                                                                                                                                                                                                                                                                                                                                                                                                                                                                                                                                                                                                                                                                                                                                                                                                                                                                                                                                                                                                                                                                                                                                                                                                                                                                                                                                                                                                                                                                                                                                                                                                                                                                                                                                                                                                                                                                                                                                                                                                                                                                                                                                                                                                                                                                                                                                                                                                                                                                                                                                                                                                                                                                                                                                                                                                                                                                                                                                                                                                                                                                                                                                                                                                                                                                                                                                                                                                                                                                                                                                                                                                                                                                                                                                                                                                                                                                                                                                                                                                                                                                                                                                                                                                                                                                                                                                                                                                                                                                                                                                                                                                                                                                                                                                                                                                                                                                                                                                                                                                                                                                                                                                                                                                                                                                                                                                                                                                                                                                                                                                                                                                                                                                                                                                                                                                                                                                                                                                                                                                                                                                                                                                                                                                                                                                                                                                                                                                                                                                                                                                                                                                                                                                                                                                                                                                                                                                                                                                                                                                                                                                                                                                                                                                                                                                                                                                                                                                                                                                                                                                                                                                                                                                                                                                                                                                                                                                                                                                                                                                                                                                                                                                                                                                                                                                                                                                                                                                                                                                                                                                                                                                                                                                                                                                                                                                                                                                                                                                                                                                                                                                                                                                                                                                                                                                                                                                                                                                                                                                                                                                                                                                                                                                                                                                                                                                                                                                                                                                                                                                                                                                                                                                                                                                                                                                                                                                                                                                                                                                                                                                                                                                                                                                                                                                                                                                                                                                                                                                                                                                                                                                                                                                                                                                                                                                                                                                                                                                                                                                                                                                                                                                                                                                                                                                                                                                                                                                                                                                                                                                                                                                                                                                                                                                                                                                                                                                                                                                                                                                                                                                                                                                                                                                                                                                                                                                                                                                                                                                                                                                                                                                                                                                                                                                                                                                                                                                                                                                                                                                                                                                                                                                                                                                                                                                                                                                                                                                                                                                                                                                                                                                                                                                                                                                                                                                                                                                                                                                                                                                                                                                                                                                                                                                                                                                                                                                                                                                                                                                                                                                                                                                                                                                                                                                                                                                                                                                                                                                                                                                                                                                                                                                                                                                                                                                                                                                                                                                                                                                                                                                                                                                                                                                                                                                                                                                                                                                                                                                                                                                                                                                                                                                                                                                                                                                                                                                                                                                                                                                                                                                                                                                                                                                                                                                                                                                                                                                                                                                                                                                                                                                                                                                                                                                                                                                                                                                                                                                                                                                                                                                                                                                                                                                                                                                                                                                                                                                                                                                                                                                                                                                                                                                                                                                                                                                                                                                                                                                                                                                                                                                                                                                                                                                                                                                                                                                                                                                                                                                                                                                                                                                                                                                                                                                                                                                                                                                                                                                                                                                                                                                                                                                                                                                                                                                                                                                                                                                                                                                                                                                                                                                                                                                                                                                                                                                                                                                                                                                                                                                                                                                                                                                                                                                                                                                                                                                                                                                                                                                                                                                                                                                                                                                                                                                                                                                                                                                                                                                                                                                                                                                                                                                                                                                                                                                                                                                                                                                                                                                                                                                                                                                                                                                                                                                                                                                                                                                                                                                                                                                                                                                                                                                                                                                                                                                                                                                                                                                                                                                                                                                                                                                                                                                                                                                                                                                                                                                                                                                                                                                                                                                                                                                                                                                                                                                                                                                                                                                                                                                                                